border_size=1
usage=map

_off^_usr   , _off^_usr   , _off^_usr   , _off^_usr   , _off^_usr   , _off^_usr   , _off^_usr   , _off^_usr   , _off^_usr   , _off^_usr   , _off^_usr   , _off^_usr   , _off^_usr   , _off^_usr   , _off^_usr   , _off^_usr   , _off^_usr   , _off^_usr   , Wo          , Wo          , Wo          , Wo          , Wo          , Wo          , Wo          , Ww          , Ww          , Ww          , Ww          , Ww          , Ww          , Ww          , Wo          , Wo          , Wo          , Wo          , Wo          , Wo          , Wo          , Wo          , Wo          , Wo          , Wo          , Wo          , Wo          , Wo          , Wo          , Wo          , Wo          , Wo          , Wo          , Ww          , Wo          , Ww          , Ww          , Ww          , Ww          , Ww          , Ww          , Ww          
_off^_usr   , _off^_usr   , _off^_usr   , _off^_usr   , _off^_usr   , _off^_usr   , _off^_usr   , _off^_usr   , _off^_usr   , _off^_usr   , _off^_usr   , _off^_usr   , _off^_usr   , _off^_usr   , _off^_usr   , _off^_usr   , _off^_usr   , _off^_usr   , Wo          , Wo          , Wo          , Wo          , Wwr         , Wo          , Ww          , Ww          , Ww          , Wo          , Wo          , Ww          , Wo          , Ww          , Ww          , Ww          , Gs^Fp       , Wo          , Gs^Fp       , Ds          , Ds          , Ds          , Gs^Fp       , Gs^Fp       , Gs^Fp       , Wo          , Wo          , Wo          , Ds          , Wo          , Ds          , Wo          , Wo          , Wo          , Wwr         , Wo          , Ww          , Wo          , Wwr         , Wo          , Ww          , Ww          
_off^_usr   , _off^_usr   , _off^_usr   , _off^_usr   , _off^_usr   , _off^_usr   , _off^_usr   , _off^_usr   , _off^_usr   , _off^_usr   , _off^_usr   , _off^_usr   , _off^_usr   , _off^_usr   , _off^_usr   , _off^_usr   , _off^_usr   , _off^_usr   , Wo          , Wo          , Wo          , Wwr         , Ww          , Ww          , Ww          , Ww          , Ww          , Wo          , Wwr         , Wo          , Ww          , Wwr         , Gs^Fp       , Gs^Fp       , Ds          , Gs^Fp       , Gs^Fp       , Gs^Fp       , Hh          , Gs^Fp       , Ds          , Gs^Fp       , Gs^Fp       , Ww          , Gs^Fp       , Gs^Fp       , Gs^Fp       , Gs^Fp       , Gs^Fp       , Gs^Fp       , Gs^Uf       , Ww          , Gs^Fp       , Gs^Uf       , Ds          , Ww          , Ww          , Wo          , Wo          , Ww          
_off^_usr   , _off^_usr   , _off^_usr   , _off^_usr   , _off^_usr   , _off^_usr   , _off^_usr   , _off^_usr   , _off^_usr   , _off^_usr   , _off^_usr   , _off^_usr   , _off^_usr   , _off^_usr   , _off^_usr   , _off^_usr   , _off^_usr   , _off^_usr   , Wo          , Wwr         , Ww          , Ww          , Ww          , Ww          , Ds          , Ww          , Wwf         , Wwf         , Wwf         , Ww          , Wwr         , Wwr         , Ds          , Gs^Fp       , Ds          , Gs^Fp       , Re          , Hh          , Mm          , Hh^Uf       , Ss          , Ds          , Gs^Fp       , Gs^Fp       , Gs^Fp       , Hh^Vo       , Re          , Gs^Fp       , Re          , Gs^Fp       , Gs^Fp       , Gs^Fp       , Gs^Fp       , Gs^Fp       , Gs^Fp       , Gs^Fp       , Ds          , Ww          , Wo          , Ww          
_off^_usr   , _off^_usr   , _off^_usr   , _off^_usr   , _off^_usr   , _off^_usr   , _off^_usr   , _off^_usr   , _off^_usr   , _off^_usr   , _off^_usr   , _off^_usr   , _off^_usr   , _off^_usr   , _off^_usr   , _off^_usr   , _off^_usr   , _off^_usr   , Wo          , Wwr         , Ww          , Ww          , Gs^Fp       , Gs^Fp       , 4 Ke        , Ds          , Ce          , Ds          , Gs^Fp       , Wwf         , Wwf         , Wwf         , Gs^Fp       , Gs^Fp       , Gs^Fp       , Gs^Fp       , Re          , Gs^Fp       , Gs^Fp       , Ss          , Ds          , Ss          , Ss          , Hh          , Re          , Re          , Gs^Fp       , Re          , Gs^Fp       , Re          , Gs^Fp       , Re          , Gs^Fp       , Re          , Re          , Cv          , Gs^Fet      , Gs^Fp       , Wo          , Ww          
_off^_usr   , _off^_usr   , _off^_usr   , _off^_usr   , _off^_usr   , _off^_usr   , _off^_usr   , _off^_usr   , _off^_usr   , _off^_usr   , _off^_usr   , _off^_usr   , _off^_usr   , _off^_usr   , _off^_usr   , _off^_usr   , _off^_usr   , _off^_usr   , Wwr         , Ww          , Ww          , Ww          , Ds          , Hh          , Hh          , Ce          , Gs^Fp       , Gs^Fp       , Gs^Vht      , Gs^Fp       , Mm          , Gs^Fp       , Mm          , Gs^Fp       , Re          , Re          , Gs^Fp       , Re          , Re          , Hh^Vo       , Gs^Uf       , Gs^Uf       , Ss^Vhs      , Re          , Gs^Fp       , Gs^Fp       , Gs^Fp       , Gs^Fp       , Gs^Fp       , Gs^Fp       , Ww          , Gs^Fp       , Gs^Fp       , Gs^Vht      , Cv          , 5 Kv        , Gs^Fet      , Gs^Vht      , Ww          , Ww          
_off^_usr   , _off^_usr   , _off^_usr   , _off^_usr   , _off^_usr   , _off^_usr   , _off^_usr   , _off^_usr   , _off^_usr   , _off^_usr   , _off^_usr   , _off^_usr   , _off^_usr   , _off^_usr   , _off^_usr   , _off^_usr   , _off^_usr   , _off^_usr   , Ww          , Ww          , Ww          , Ww          , Gs^Fp       , Mm          , Hh          , Ss^Vhs      , Ss          , Ss          , Ss          , Hh          , Mm          , Mm          , Re          , Re          , Ss          , Hh^Vo       , Gs^Fp       , Gs^Fp       , Gs^Fp       , Re          , Hh          , Gs^Uf       , Gs^Fp       , Ss          , Hh          , Gs^Fp       , Wwr         , Ww          , Wwr         , Ww          , Wo          , Ww          , Ww          , Gs^Fp       , Gs^Fet      , Cv          , Gs^Fet      , Ds          , Ww          , Ww          
_off^_usr   , _off^_usr   , _off^_usr   , _off^_usr   , _off^_usr   , _off^_usr   , _off^_usr   , _off^_usr   , _off^_usr   , _off^_usr   , _off^_usr   , _off^_usr   , _off^_usr   , _off^_usr   , _off^_usr   , _off^_usr   , _off^_usr   , _off^_usr   , Ww          , Wo          , Ww          , Ww          , Wwf         , Gs^Fp       , Gs^Fp       , Hh          , Gs^Fp       , Gs^Uf       , Gs^Fp       , Hh          , Hh          , Re          , Ss          , Ss          , Gs^Fp       , Gs^Fp       , Hh          , Gs^Uf       , Gs^Fp       , Re          , Gs^Fp       , Gs^Fp       , Gs^Fp       , Gs^Fp       , Gs^Fp       , Gs^Fp       , Ww          , Wo          , Wo          , Wo          , Ww          , Wo          , Wo          , Gs^Fp       , Gs^Fp       , Gs^Fp       , Gs^Fp       , Ds          , Ww          , Ww          
_off^_usr   , _off^_usr   , _off^_usr   , _off^_usr   , _off^_usr   , _off^_usr   , _off^_usr   , _off^_usr   , _off^_usr   , _off^_usr   , _off^_usr   , _off^_usr   , _off^_usr   , _off^_usr   , _off^_usr   , _off^_usr   , _off^_usr   , _off^_usr   , Ww          , Wo          , Ww          , Ww          , Ww          , Wwf         , Ww          , Gs^Fp       , Ww          , Gs^Fp       , Re          , Re          , Mm          , Hh          , Ss          , Ss          , Ss          , Re          , Gs^Fp       , Re          , Gs^Fp       , Gs^Fp       , Mm          , Re          , Re          , Ss          , Mm          , Mm          , Mm          , Ww          , Mm          , Gs^Fp       , Gs^Fp       , Wwr         , Wwr         , Wo          , Wo          , Ds          , Ww          , Ww          , Ww          , Ww          
_off^_usr   , _off^_usr   , _off^_usr   , _off^_usr   , _off^_usr   , _off^_usr   , _off^_usr   , _off^_usr   , _off^_usr   , _off^_usr   , _off^_usr   , _off^_usr   , _off^_usr   , _off^_usr   , _off^_usr   , _off^_usr   , _off^_usr   , _off^_usr   , Ww          , Ww          , Ww          , Ww          , Wwr         , Wwf         , Ww          , Ww          , Gs^Fp       , Gs^Fp       , Re          , Gs^Fp       , Gs^Fp       , Gs^Fp       , Re          , Re          , Hh^Vc       , Ss          , Re          , Gs^Fp       , Re          , Mm          , Mm          , Mm          , Re          , Mm          , Gs^Fp       , Mm          , Mm          , Mm          , Ss          , Gs^Fp       , Gs^Fp       , Gs^Fp       , Ww          , Ww          , Wo          , Wo          , Wo          , Wo          , Ww          , Ww          
_off^_usr   , _off^_usr   , _off^_usr   , _off^_usr   , _off^_usr   , _off^_usr   , _off^_usr   , _off^_usr   , _off^_usr   , _off^_usr   , _off^_usr   , _off^_usr   , _off^_usr   , _off^_usr   , _off^_usr   , _off^_usr   , _off^_usr   , _off^_usr   , Ww          , Wwr         , Wwr         , Wwr         , Ww          , Wwf         , Ww          , Gs^Uf       , Hh^Vo       , Gs^Fp       , Re          , Ss          , Gs^Fp       , Gs^Fp       , Gs^Fp       , Gs^Fp       , Gs^Fp       , Re          , Ss          , Re          , Gs^Fp       , Gs^Fp       , Gs^Fp       , Gs^Fp       , Gs^Fp       , Re          , Gs^Vht      , Re          , Re          , Gs^Fp       , Gs^Fp       , Ss          , Gs^Fp       , Ds          , Ds          , Ww          , Wo          , Ww          , Wo          , Ww          , Ww          , Ww          
_off^_usr   , _off^_usr   , _off^_usr   , _off^_usr   , _off^_usr   , _off^_usr   , _off^_usr   , _off^_usr   , _off^_usr   , _off^_usr   , _off^_usr   , _off^_usr   , _off^_usr   , _off^_usr   , _off^_usr   , _off^_usr   , _off^_usr   , _off^_usr   , Ww          , Wwr         , Wo          , Wo          , Wwf         , Wwf         , Hh          , Ds          , Ss          , Gs^Fp       , Gs^Fp       , Re          , Gs^Fp       , Hh          , Gs^Fp       , Gs^Fp       , Ss          , Hh          , Ss          , Ss          , Gs^Fp       , Re          , Gs^Fp       , Gs^Fp       , Gs^Fp       , Gs^Fp       , Gs^Fp       , Gs^Fp       , Gs^Fp       , Gs^Fp       , Gs^Fp       , Ss^Emf      , Ss^Emf      , Gs^Fp       , Gs^Fp       , Ww          , Wwr         , Wo          , Ww          , Wo          , Wo          , Ww          
_off^_usr   , _off^_usr   , _off^_usr   , _off^_usr   , _off^_usr   , _off^_usr   , _off^_usr   , _off^_usr   , _off^_usr   , _off^_usr   , _off^_usr   , _off^_usr   , _off^_usr   , _off^_usr   , _off^_usr   , _off^_usr   , _off^_usr   , _off^_usr   , Ww          , Ww          , Wo          , Ww          , Hh          , Ds          , Ss          , Ss          , Ds          , Hh          , Gs^Fp       , Gs^Fp       , Ss          , Ss          , Re          , Re          , Gd^Fetd     , Ss          , Ds^Uf       , Ds          , Gs^Fp       , Re          , Re          , Gs^Fp       , Ss^Vhs      , Ss          , Ds          , Gs^Fp       , Gs^Fp       , Re          , Re          , Gs^Fp       , Ss^Emf      , Gs^Fp       , Gs^Fp       , Ww          , Wo          , Ww          , Ww          , Wo          , Ww          , Ww          
_off^_usr   , _off^_usr   , _off^_usr   , _off^_usr   , _off^_usr   , _off^_usr   , _off^_usr   , _off^_usr   , _off^_usr   , _off^_usr   , _off^_usr   , _off^_usr   , _off^_usr   , _off^_usr   , _off^_usr   , _off^_usr   , _off^_usr   , _off^_usr   , Ww          , Wwr         , Ww          , Ww          , Ww          , Hh          , Gs^Fp       , Hh          , Gs^Fp       , Gs^Fp       , Gs^Fp       , Re          , Gs^Fp       , Re          , Gs^Fp       , Gs^Fp       , Re          , Ss          , Dd^Vdt      , Ds          , Gs^Fp       , Gs^Fp       , Gs^Fp       , Re          , Gs^Fp       , Ss          , Ds          , Hh          , Hh          , Gs^Fp       , Re          , Gs^Fp       , Ss          , Gs^Fp       , Gs^Fp       , Ww          , Ww          , Wo          , Ww          , Wo          , Ww          , Ww          
_off^_usr   , _off^_usr   , _off^_usr   , _off^_usr   , _off^_usr   , _off^_usr   , _off^_usr   , _off^_usr   , _off^_usr   , _off^_usr   , _off^_usr   , _off^_usr   , _off^_usr   , _off^_usr   , _off^_usr   , _off^_usr   , _off^_usr   , _off^_usr   , Wo          , Ww          , Ww          , Wwr         , Wwf         , Ds          , Gs^Fp       , Gs^Fp       , Re          , Re          , Gs^Fp       , Gs^Fp       , Re          , Gs^Vht      , Gs^Fp       , Ss          , Gs^Fp       , Ss          , Ss          , Ds          , Ss          , Gs^Fp       , Gs^Fp       , Gs^Fp       , Gs^Fp       , Ss          , Hh          , Hh          , Hh^Vc       , Gs^Fp       , Re          , Gs^Fp       , Gs^Fp       , Mm          , Gs^Fp       , Ww          , Ww          , Wwr         , Wo          , Ww          , Ww          , Ww          
_off^_usr   , _off^_usr   , _off^_usr   , _off^_usr   , _off^_usr   , _off^_usr   , _off^_usr   , _off^_usr   , _off^_usr   , _off^_usr   , _off^_usr   , _off^_usr   , _off^_usr   , _off^_usr   , _off^_usr   , _off^_usr   , _off^_usr   , _off^_usr   , Wo          , Wo          , Wo          , Wwr         , Wwf         , Gs^Fp       , Gs^Uf       , Re          , Mm          , Gs^Fp       , Hh          , Re          , Gs^Fp       , Gs^Fp       , Hh          , Mm          , Hh          , Gs^Fp       , Gs^Fp       , Ss          , Re          , Re          , Re          , Re          , Re          , Re          , Gs^Fp       , Gs^Fp       , Ss          , Gs^Fp       , Gs^Fp       , Gs^Fp       , Gs^Fp       , Gs^Fp       , Gs^Fp       , Gs^Fp       , Gs^Fp       , Ww          , Ww          , Wo          , Ww          , Ww          
_off^_usr   , _off^_usr   , _off^_usr   , _off^_usr   , _off^_usr   , _off^_usr   , _off^_usr   , _off^_usr   , _off^_usr   , _off^_usr   , _off^_usr   , _off^_usr   , _off^_usr   , _off^_usr   , _off^_usr   , _off^_usr   , _off^_usr   , _off^_usr   , Wo          , Wo          , Wo          , Wo          , Wo          , Gs^Fp       , Gs^Fp       , Hh          , Gs^Fp       , Hh          , Re          , Re          , Gs^Fp       , Gs^Fp       , Gs^Fp       , Gs^Fp       , Gs^Fp       , Gs^Fp       , Ds          , Gs^Fp       , Ss^Uf       , Gs^Fp       , Gs^Fp       , Gs^Fp       , Gs^Fp       , Gs^Fp       , Gs^Fp       , Ds          , Ds          , Ss          , Ss          , Gs^Fp       , Gs^Fp       , Re          , Re          , Gs^Fp       , Hh^Vhh      , Hh          , Gs^Fp       , Ww          , Ww          , Ww          
_off^_usr   , _off^_usr   , _off^_usr   , _off^_usr   , _off^_usr   , _off^_usr   , _off^_usr   , _off^_usr   , _off^_usr   , _off^_usr   , _off^_usr   , _off^_usr   , _off^_usr   , _off^_usr   , _off^_usr   , _off^_usr   , _off^_usr   , _off^_usr   , Wo          , Wo          , Wo          , Wo          , Ds          , Gs^Fp       , Re          , Gs^Fp       , Re          , Re          , Re          , Gs^Fp       , Ss          , Hh^Vo       , Gs^Fp       , Gs^Fp       , Wwf         , Gs^Fp       , Gs^Fp       , Ss          , Ss          , Ss          , Ss          , Ds          , Gs^Uf       , Gs^Uf       , Gs^Fp       , Gs^Fp       , Gs^Fp       , Ds          , Gs^Fp       , Ss          , Gs^Fp       , Hh          , Re          , Gs^Fp       , Gs^Fp       , Hh          , Gs^Fp       , Ww          , Ww          , Ww          
_off^_usr   , _off^_usr   , _off^_usr   , _off^_usr   , _off^_usr   , _off^_usr   , _off^_usr   , _off^_usr   , _off^_usr   , _off^_usr   , _off^_usr   , _off^_usr   , _off^_usr   , _off^_usr   , _off^_usr   , _off^_usr   , _off^_usr   , _off^_usr   , Wo          , Wo          , Ww          , Wo          , Gs^Fp       , Gs^Fp       , Gs^Fp       , Re          , Re          , Re          , Gs^Fp       , Gs^Fp       , Ss          , Ss          , Ds          , Ds          , Wwf         , Ww          , Ww          , Gs^Fp       , Gs^Fp       , Ss^Vhs      , Gs^Fp       , Ss          , Gs^Fp       , Gs^Fp       , Wwr         , Wwf         , Wwr         , Gs^Fp       , Gs^Fp       , Gs^Fp       , Hh^Vhh      , Hh          , Gs^Fp       , Re          , Gs^Fp       , Ds          , Gs^Fp       , Ww          , Ww          , Ww          
_off^_usr   , _off^_usr   , _off^_usr   , _off^_usr   , _off^_usr   , _off^_usr   , _off^_usr   , _off^_usr   , _off^_usr   , _off^_usr   , _off^_usr   , _off^_usr   , _off^_usr   , _off^_usr   , _off^_usr   , _off^_usr   , _off^_usr   , _off^_usr   , Ww          , Ww          , Ww          , Wwf         , Hh          , Hh^Vo       , Gs^Fp       , Gs^Fp       , Re          , Gs^Fp       , Ss          , Ss          , Gs^Fp       , Ss          , Wwf         , Wwf         , Ww          , Ww          , Ww          , Ww          , Ww          , Wwf         , Wwf         , Wwf         , Wwr         , Wwf         , Wo          , Wo          , Wwr         , Wwr         , Gs^Fp       , Gs^Fp       , Gs^Fp       , Gs^Fp       , Gs^Fp       , Gs^Fp       , Ds          , Ds          , Ss          , Ds          , Ww          , Ww          
_off^_usr   , _off^_usr   , _off^_usr   , _off^_usr   , _off^_usr   , _off^_usr   , _off^_usr   , _off^_usr   , _off^_usr   , _off^_usr   , _off^_usr   , _off^_usr   , _off^_usr   , _off^_usr   , _off^_usr   , _off^_usr   , _off^_usr   , _off^_usr   , Ww          , Ww          , Ww          , Wwf         , Gs^Fp       , Gs^Fp       , Re          , Re          , Re          , Ss          , Gs^Fp       , Re          , Gs^Fp       , Ss          , Ww          , Ww          , Wo          , Wo          , Ww          , Wwr         , Ww          , Ww          , Ww          , Ww          , Ww          , Wo          , Ww          , Ww          , Gs^Fp       , Gs^Fp       , Gs^Fp       , Gs^Fp       , Gs^Fp       , Re          , Gs^Fp       , Gs^Fp       , Ds          , Ss          , Ss          , Gs^Fp       , Ww          , Ww          
_off^_usr   , _off^_usr   , _off^_usr   , _off^_usr   , _off^_usr   , _off^_usr   , _off^_usr   , _off^_usr   , _off^_usr   , _off^_usr   , _off^_usr   , _off^_usr   , _off^_usr   , _off^_usr   , _off^_usr   , _off^_usr   , _off^_usr   , _off^_usr   , Ww          , Wo          , Wwr         , Wwf         , Wwf         , Gs^Fp       , Gs^Fp       , Re          , Gs^Fp       , Re          , Re          , Re          , Gs^Fp       , Ds          , Ww          , Ww          , Wo          , Ww          , Wwr         , Ww          , Wo          , Wo          , Wo          , Wo          , Wwr         , Wo          , Ww          , Gs^Fp       , Hh^Vhh      , Hh          , Ss          , Gs^Fp       , Re          , Re          , Gs^Fp       , Gs^Fp       , Gs^Fp       , Hh^Vhh      , Gs^Fp       , Gs^Fp       , Ww          , Ww          
_off^_usr   , _off^_usr   , _off^_usr   , _off^_usr   , _off^_usr   , _off^_usr   , _off^_usr   , _off^_usr   , _off^_usr   , _off^_usr   , _off^_usr   , _off^_usr   , _off^_usr   , _off^_usr   , _off^_usr   , _off^_usr   , _off^_usr   , _off^_usr   , Ww          , Ww          , Wwr         , Wwr         , Dd^Vdt      , Gs^Fp       , Re          , Gs^Fp       , Re          , Re          , Re          , Gs^Fp       , Gs^Fp       , Ww          , Ww          , Ww          , Wwr         , Wwr         , Wo          , Wo          , Wo          , Wo          , Wo          , Wo          , Ww          , Wo          , Ww          , Gs^Fp       , Ss          , Ss          , Gs^Uf       , Gs^Fp       , Re          , Gs^Fp       , Re          , Re          , Gs^Fp       , Gs^Fp       , Gs^Fp       , Ww          , Wo          , Ww          
_off^_usr   , _off^_usr   , _off^_usr   , _off^_usr   , _off^_usr   , _off^_usr   , _off^_usr   , _off^_usr   , _off^_usr   , _off^_usr   , _off^_usr   , _off^_usr   , _off^_usr   , _off^_usr   , _off^_usr   , _off^_usr   , _off^_usr   , _off^_usr   , Ww          , Wwr         , Wwr         , Ds          , Gs^Fp       , Re          , Gs^Fp       , Re          , Gs^Fp       , Gs^Fp       , Gs^Fp       , Gs^Fp       , Co          , Gs^Fp       , Gs^Fp       , Ww          , Ww          , Wwr         , Wo          , Wo          , Wo          , Wo          , Wo          , Wo          , Ww          , Ww          , Ww          , Gs^Fp       , Ss          , Gs^Uf       , Gs^Fp       , Re          , Re          , Re          , Re          , Re          , Re          , Re^Uf       , Re^Uf       , Gs^Fp       , Wo          , Wo          
_off^_usr   , _off^_usr   , _off^_usr   , _off^_usr   , _off^_usr   , _off^_usr   , _off^_usr   , _off^_usr   , _off^_usr   , _off^_usr   , _off^_usr   , _off^_usr   , _off^_usr   , _off^_usr   , _off^_usr   , _off^_usr   , _off^_usr   , _off^_usr   , Ww          , Ww          , Ww          , Dd^Vdt      , Re          , Re          , Hh^Vo       , Hh^Vo       , Re          , Hh^Vo       , Re          , Re          , Co          , 3 Ko        , Gs^Fp       , Ww          , Ww          , Ww          , Wo          , Wo          , Wwr         , Wwr         , Wo          , Wo          , Wo          , Ww          , Ww          , Gs^Fp       , Ss          , Gs^Fp       , Gs^Fp       , Re          , Wwf         , Gs^Fp       , Ch          , Gs^Fp       , Wwf         , Re          , Re^Uf       , Gs^Fp       , Wo          , Wo          
_off^_usr   , _off^_usr   , _off^_usr   , _off^_usr   , _off^_usr   , _off^_usr   , _off^_usr   , _off^_usr   , _off^_usr   , _off^_usr   , _off^_usr   , _off^_usr   , _off^_usr   , _off^_usr   , _off^_usr   , _off^_usr   , _off^_usr   , _off^_usr   , Wo          , Ww          , Ww          , Gs^Fp       , Gs^Fp       , Co          , 2 Ko        , Hh          , Co          , Co          , Re          , Re          , Re          , Hh^Vo       , Gs^Fp       , Ww          , Ww          , Ww          , Wo          , Wo          , Wwr         , Wo          , Wo          , Wo          , Wo          , Ww          , Ww          , Wwf         , Gs^Fp       , Ss^Uf       , Gs^Fp       , Wwf         , Ch          , Ch          , 6 Kh        , Ch          , Ch          , Wwf         , Gs^Fp       , Gs^Fp       , Wo          , Wo          
_off^_usr   , _off^_usr   , _off^_usr   , _off^_usr   , _off^_usr   , _off^_usr   , _off^_usr   , _off^_usr   , _off^_usr   , _off^_usr   , _off^_usr   , _off^_usr   , _off^_usr   , _off^_usr   , _off^_usr   , _off^_usr   , _off^_usr   , _off^_usr   , Wo          , Ww          , Wwr         , Ww          , Wwf^Bw/     , Co          , Hh^Vo       , 1 Ko        , Hh^Vo       , Gs^Fp       , Re          , Re          , Hh^Vo       , Ds          , Ww          , Ww          , Ww          , Wo          , Wo          , Wo          , Wwr         , Wo          , Wo          , Wwr         , Wwr         , Wo          , Ww          , Wwf         , Wwf         , Ss          , Gs^Fp       , Wwf         , Wwf         , Wwf         , Wwf         , Wwf         , Wwf         , Wwf         , Gs^Fp       , Ds          , Wo          , Wo          
_off^_usr   , _off^_usr   , _off^_usr   , _off^_usr   , _off^_usr   , _off^_usr   , _off^_usr   , _off^_usr   , _off^_usr   , _off^_usr   , _off^_usr   , _off^_usr   , _off^_usr   , _off^_usr   , _off^_usr   , _off^_usr   , _off^_usr   , _off^_usr   , Wo          , Ww          , Wo          , Wwf         , Ww          , Ww          , Ww          , Hh^Vo       , Gs^Fp       , Re          , Gs^Fp       , Hh^Vo       , Gs^Fp       , Ww          , Ww          , Ww          , Ww          , Wo          , Wo          , Wo          , Wwr         , Wo          , Wo          , Wwr         , Wo          , Wo          , Ww          , Ww          , Ww          , Wwf         , Gs^Fp       , Hh^Vhh      , Gs^Fp       , Gs^Fp       , Hh^Vhh      , Gs^Fp       , Gs^Fp       , Gs^Fp       , Wo          , Wo          , Wo          , Wo          
_off^_usr   , _off^_usr   , _off^_usr   , _off^_usr   , _off^_usr   , _off^_usr   , _off^_usr   , _off^_usr   , _off^_usr   , _off^_usr   , _off^_usr   , _off^_usr   , _off^_usr   , _off^_usr   , _off^_usr   , _off^_usr   , _off^_usr   , _off^_usr   , Wo          , Ww          , Wwr         , Wo          , Wo          , Ww          , Ww          , Ww          , Gs^Fp       , Gs^Fp       , Ds          , Ds          , Ds          , Ww          , Wo          , Wo          , Ww          , Wo          , Wo          , Wwr         , Wo          , Wo          , Wo          , Wwr         , Wo          , Wo          , Ww          , Ww          , Ww          , Ww          , Ww          , Gs^Fp       , Gs^Uf       , Hh^Uf       , Gs^Fp       , Hh          , Ww          , Ww          , Wo          , Wo          , Wo          , Wo          
_off^_usr   , _off^_usr   , _off^_usr   , _off^_usr   , _off^_usr   , _off^_usr   , _off^_usr   , _off^_usr   , _off^_usr   , _off^_usr   , _off^_usr   , _off^_usr   , _off^_usr   , _off^_usr   , _off^_usr   , _off^_usr   , _off^_usr   , _off^_usr   , Wo          , Ww          , Ww          , Ww          , Wo          , Ww          , Wwr         , Ww          , Ww          , Ds          , Gs^Fp       , Dd^Vdt      , Ww          , Ww          , Wo          , Ww          , Ww          , Wo          , Wo          , Wo          , Wo          , Wo          , Wo          , Wo          , Wwr         , Wo          , Ww          , Ww          , Ww          , Ww          , Ww          , Ww          , Ww          , Ww          , Ww          , Wwr         , Wwr         , Wwr         , Wo          , Wo          , Wo          , Wo          
_off^_usr   , _off^_usr   , _off^_usr   , _off^_usr   , _off^_usr   , _off^_usr   , _off^_usr   , _off^_usr   , _off^_usr   , _off^_usr   , _off^_usr   , _off^_usr   , _off^_usr   , _off^_usr   , _off^_usr   , _off^_usr   , _off^_usr   , _off^_usr   , Wo          , Wo          , Wo          , Ww          , Ww          , Wo          , Ww          , Ww          , Ww          , Ww          , Ww          , Ww          , Ww          , Wo          , Ww          , Wwr         , Ww          , Wo          , Wo          , Wo          , Wo          , Wo          , Wo          , Wwr         , Wo          , Wo          , Wo          , Ww          , Ww          , Wo          , Wo          , Wo          , Ww          , Wo          , Ww          , Wwr         , Wo          , Wo          , Wo          , Wo          , Wo          , Wo          
_off^_usr   , _off^_usr   , _off^_usr   , _off^_usr   , _off^_usr   , _off^_usr   , _off^_usr   , _off^_usr   , _off^_usr   , _off^_usr   , _off^_usr   , _off^_usr   , _off^_usr   , _off^_usr   , _off^_usr   , _off^_usr   , _off^_usr   , _off^_usr   , Wwr         , Wo          , Wwr         , Wo          , Wo          , Ww          , Ww          , Ww          , Wo          , Ww          , Wo          , Ww          , Wo          , Ww          , Ww          , Ww          , Wo          , Wo          , Wo          , Wo          , Wo          , Wo          , Wo          , Wo          , Wo          , Wo          , Ww          , Ww          , Wo          , Wo          , Wo          , Wo          , Wo          , Wo          , Ww          , Wo          , Wo          , Wo          , Wo          , Wo          , Wo          , Wo          
_off^_usr   , _off^_usr   , _off^_usr   , _off^_usr   , _off^_usr   , _off^_usr   , _off^_usr   , _off^_usr   , _off^_usr   , _off^_usr   , _off^_usr   , _off^_usr   , _off^_usr   , _off^_usr   , _off^_usr   , _off^_usr   , _off^_usr   , _off^_usr   , Ww          , Wo          , Wo          , Wo          , Wo          , Wo          , Wo          , Wo          , Wo          , Wo          , Wo          , Wo          , Ww          , Wo          , Wo          , Wo          , Wo          , Wo          , Ww          , Ww          , Wo          , Wo          , Wo          , Wo          , Ww          , Wo          , Wo          , Wo          , Ww          , Ww          , Wo          , Wo          , Ww          , Ww          , Ww          , Wo          , Wo          , Wo          , Wo          , Wo          , Wo          , Wo          
