border_size=1
usage=map

_off^_usr   , _off^_usr   , _off^_usr   , _off^_usr   , _off^_usr   , _off^_usr   , _off^_usr   , _off^_usr   , _off^_usr   , _off^_usr   , _off^_usr   , _off^_usr   , _off^_usr   , _off^_usr   , _off^_usr   , _off^_usr   , _off^_usr   , _off^_usr   , Wot         , Wot         , Wot         , Wot         , Wot         , Wot         , Wwt         , Wo          , Wwt         , Wwt         , Wot         , Wot         , Wwt         , Wwt         , Wwt         , Wot         , Wot         , Wot         , Wwt         , Wo          , Wwt         , Wwt         , Wot         , Wot         , Wot         , Wot         
_off^_usr   , _off^_usr   , _off^_usr   , _off^_usr   , _off^_usr   , _off^_usr   , _off^_usr   , _off^_usr   , _off^_usr   , _off^_usr   , _off^_usr   , _off^_usr   , _off^_usr   , _off^_usr   , _off^_usr   , _off^_usr   , _off^_usr   , _off^_usr   , Wot         , Wwr         , Wwr         , Wot         , Wwt         , Wot         , Wwt         , Wwt         , Wwt         , Wwt         , Wwt         , Wwt         , Wwt         , Wot         , Wwt         , Wot         , Wwt         , Wot         , Wwt         , Wwt         , Wwr         , Wot         , Wwt         , Wot         , Wwt         , Wot         
_off^_usr   , _off^_usr   , _off^_usr   , _off^_usr   , _off^_usr   , Ww^ZBw|     , _off^_usr   , _off^_usr   , _off^_usr   , _off^_usr   , _off^_usr   , _off^_usr   , _off^_usr   , _off^_usr   , _off^_usr   , _off^_usr   , _off^_usr   , _off^_usr   , Wot         , Wwr         , Wwt         , Wot         , Wwt         , Wwt         , Wwr         , Wot         , Wwt         , Wwr         , Wwt         , Wwt         , Wwt         , Wwt         , Wwr         , Wwt         , Wwt         , Wwt         , Wwt         , Wwt         , Wwt         , Wwt         , Wwr         , Wwt         , Wwt         , Wwt         
_off^_usr   , _off^_usr   , _off^_usr   , _off^_usr   , _off^_usr   , _off^_usr   , _off^_usr   , _off^_usr   , _off^_usr   , _off^_usr   , _off^_usr   , _off^_usr   , _off^_usr   , _off^_usr   , _off^_usr   , _off^_usr   , _off^_usr   , _off^_usr   , Wot         , Wwt         , Wwr         , Wwt         , Wot         , Wwr         , Wot         , Wot         , Wwt         , Wwt         , Ds          , Hh^Fdf      , Mm          , Mm          , Mm^Xm       , Mm          , Mm          , Wwt         , Mm^Fdf      , Wwt         , Wwt         , Wwt         , Wwr         , Wot         , Wot         , Wot         
_off^_usr   , _off^_usr   , _off^_usr   , _off^_usr   , _off^_usr   , 1 _off^_usr , _off^_usr   , 2 _off^_usr , _off^_usr   , _off^_usr   , _off^_usr   , _off^_usr   , _off^_usr   , _off^_usr   , _off^_usr   , _off^_usr   , _off^_usr   , _off^_usr   , Wot         , Wot         , Wwt         , Wwt         , Wwt         , Wot         , Wwt         , Wwt         , Ds          , Ds^Uf       , Hh          , Hh          , Hh          , Mm^Xm       , Hh^Xo       , Mm^Xm       , Mm          , Mm          , Mm          , Mm          , Mm          , Wwt         , Wwt         , Wwr         , Wwt         , Wot         
_off^_usr   , _off^_usr   , _off^_usr   , _off^_usr   , _off^_usr   , _off^_usr   , _off^_usr   , _off^_usr   , _off^_usr   , _off^_usr   , _off^_usr   , _off^_usr   , _off^_usr   , _off^_usr   , _off^_usr   , _off^_usr   , _off^_usr   , _off^_usr   , Wot         , Wot         , Wot         , Wot         , Wwt         , Wwr         , Wwr         , Wwt         , Hh          , Mm          , Mm          , Mm          , Hh          , Mm^Xm       , Hh          , Mm^Xm       , Mm          , Mm          , Mm          , Mm          , Wwt         , Wwt         , Wwt         , Wwt         , Wot         , Wot         
_off^_usr   , _off^_usr   , _off^_usr   , _off^_usr   , _off^_usr   , _off^_usr   , _off^_usr   , _off^_usr   , _off^_usr   , _off^_usr   , _off^_usr   , _off^_usr   , _off^_usr   , _off^_usr   , _off^_usr   , _off^_usr   , _off^_usr   , _off^_usr   , Wot         , Wot         , Ww          , Wot         , Wwt         , Wwt         , Wwt         , Wwt         , Mm          , Mm          , Wwt         , Hh          , Ds          , Mm          , Re          , Mm          , Mm          , Mm          , Mm^Fdf      , Ds          , Wwt         , Wwt         , Wwt         , Wot         , Wwt         , Wwt         
_off^_usr   , _off^_usr   , _off^_usr   , _off^_usr   , _off^_usr   , _off^_usr   , _off^_usr   , _off^_usr   , _off^_usr   , _off^_usr   , _off^_usr   , _off^_usr   , _off^_usr   , _off^_usr   , _off^_usr   , _off^_usr   , _off^_usr   , _off^_usr   , Wot         , Wot         , Wot         , Wwr         , Wwt         , Wwt         , Mm          , Mm          , Wwt         , Wwt         , Wwr         , Wwt         , Wwt         , Wwr         , Wwf         , Wwf         , Wwt         , Wwt         , Wwt         , Wwt         , Wwr         , Wot         , Wot         , Wwt         , Wwt         , Wwt         
_off^_usr   , _off^_usr   , _off^_usr   , _off^_usr   , _off^_usr   , _off^_usr   , _off^_usr   , _off^_usr   , _off^_usr   , _off^_usr   , _off^_usr   , _off^_usr   , _off^_usr   , _off^_usr   , _off^_usr   , _off^_usr   , _off^_usr   , _off^_usr   , Wot         , Wot         , Wot         , Wwt         , Wwt         , Mm^Xm       , Wwt         , Wwt         , Ds          , Ds^Uf       , Mm          , Hh          , Wwf         , Wwf         , Wwr         , Wwt         , Wwr         , Wwr         , Ds          , Wwt         , Wwr         , Wwr         , Wot         , Wwt         , Wwr         , Wwt         
_off^_usr   , _off^_usr   , _off^_usr   , _off^_usr   , _off^_usr   , _off^_usr   , _off^_usr   , _off^_usr   , _off^_usr   , _off^_usr   , _off^_usr   , _off^_usr   , _off^_usr   , _off^_usr   , _off^_usr   , _off^_usr   , _off^_usr   , _off^_usr   , Wot         , Wwr         , Wwt         , Wwt         , Wo          , Wwt         , Wwt         , Wwt         , Mm          , Hh          , Mm          , Hh          , Re          , Wwf         , Mm          , Mm          , Mm^Xm       , Mm^Uf       , Mm^Fdf      , Wwt         , Wwt         , Wwr         , Ww          , Wot         , Wwr         , Wo          
_off^_usr   , _off^_usr   , _off^_usr   , _off^_usr   , _off^_usr   , _off^_usr   , _off^_usr   , _off^_usr   , _off^_usr   , _off^_usr   , _off^_usr   , _off^_usr   , _off^_usr   , _off^_usr   , _off^_usr   , _off^_usr   , _off^_usr   , _off^_usr   , Wot         , Wwr         , Wwt         , Wwt         , Wwt         , Wwr         , Wwt         , Mm          , Mm          , Mm          , Mm          , Mm          , Mm          , Mm^Xm       , Mm          , Mm^Xm       , Mm          , Mm          , Mm          , Ds^Uf       , Wwt         , Wot         , Wot         , Wwr         , Ww          , Ww          
_off^_usr   , _off^_usr   , _off^_usr   , _off^_usr   , _off^_usr   , _off^_usr   , _off^_usr   , _off^_usr   , _off^_usr   , _off^_usr   , _off^_usr   , _off^_usr   , _off^_usr   , _off^_usr   , _off^_usr   , _off^_usr   , _off^_usr   , _off^_usr   , Wot         , Wot         , Wot         , Wot         , Wwr         , Wwt         , Wwt         , Wwt         , Wwt         , Mm          , Wwt         , Mm          , Wwr         , Mm          , Mm^Xm       , Mm          , Mm          , Mm          , Wwt         , Wwt         , Wwt         , Wot         , Ww          , Wwr         , Wot         , Ww          
_off^_usr   , _off^_usr   , _off^_usr   , _off^_usr   , _off^_usr   , _off^_usr   , _off^_usr   , _off^_usr   , _off^_usr   , _off^_usr   , _off^_usr   , _off^_usr   , _off^_usr   , _off^_usr   , _off^_usr   , _off^_usr   , _off^_usr   , _off^_usr   , Wwr         , Wot         , Wot         , Wot         , Wot         , Wwr         , Wot         , Wot         , Wwt         , Wwt         , Wwt         , Wwt         , Wwt         , Wwt         , Wwt         , Wwt         , Wwt         , Wwt         , Wwt         , Wwt         , Wwt         , Wwr         , Ww          , Wot         , Ww          , Ww          
_off^_usr   , _off^_usr   , _off^_usr   , _off^_usr   , _off^_usr   , _off^_usr   , _off^_usr   , _off^_usr   , _off^_usr   , _off^_usr   , _off^_usr   , _off^_usr   , _off^_usr   , _off^_usr   , _off^_usr   , _off^_usr   , _off^_usr   , _off^_usr   , Wwr         , Wwr         , Wwr         , Wot         , Wot         , Wot         , Wot         , Wot         , Wot         , Wwt         , Wo          , Wo          , Wo          , Wwt         , Wo          , Wwr         , Wwr         , Wot         , Wot         , Wot         , Wot         , Wot         , Wot         , Wot         , Wot         , Wot         
