Wot, Wot, Wot, Wot, Wot, Wot, Wot, Wot, Wot, Wot, Wot, Wot, Wot, Wot, Wot, Wot, Wot, Wot, Wot, Wot, Wot, Wot, Wot, Wot, Wot, Wot, Wot, Wot, Wot, Wot, Wot, Wot, Wot, Wot, Wot, Wot, Wot, Wot, Wot, Wot, Wot, Wot, Wot, Wot, Wot, Wot, Wot, Wot, Wot, Wot, Wot, Wot, Wot, Wot, Wot
Wot, Wot, Wot, Wot, Wot, Wot, Wot, Wot, Wot, Wot, Wot, Wot, Wot, Wot, Wot, Wot, Wot, Wot, Wot, Wot, Wot, Wot, Wot, Wot, Wot, Wot, Wot, Wot, Wot, Wot, Wot, Wot, Wot, Wot, Wot, Wot, Wot, Wot, Wot, Wot, Wot, Wot, Wot, Wot, Wot, Wot, Wot, Wot, Wot, Wot, Wot, Wot, Wot, Wot, Wot
Wot, Wot, Wot, Wot, Wot, Wot, Wot, Wot, Wot, Wot, Wot, Wot, Wot, Wot, Wot, Wot, Wot, Wot, Wot, Wot, Wot, Wot, Wot, Wot, Wot, Wot, Wot, Wot, Wot, Wot, Wot, Wot, Wot, Wot, Wot, Wot, Wot, Wot, Xu, Xu, Xu, Xu, Xu, Xu, Xu, Wot, Wot, Wot, Wot, Wot, Wot, Wot, Wot, Wot, Wot
Wot, Wot, Wot, Wot, Wot, Wot, Wot, Wot, Wot, Wot, Wot, Wot, Wot, Wot, Wot, Wot, Wot, Wot, Wot, Wot, Wot, Wot, Wot, Wot, Wot, Wot, Wot, Wot, Wot, Wot, Wot, Wot, Wot, Wot, Wot, Wot, Wot, Xu, Zwb, Zwb, Zwb, Xu, Xu, Xu, Xu, Xu, Xu, Wot, Wot, Wot, Wot, Wot, Wot, Wot, Wot
Wot, Wot, Wot, Wot, Wot, Wot, Wot, Wot, Wot, Wot, Wot, Wot, Wot, Wot, Wot, Wot, Wot, Wot, Wot, Wot, Wot, Wot, Wot, Wot, Wot, Wot, Wot, Wot, Wot, Wot, Wot, Wot, Wot, Wot, Wot, Wot, Wot, Xu, Zwb, Zwb, Xu, Xu, Xu, Xu, Xu, Qlf, Xu, Xu, Xu, Wot, Wot, Wot, Wot, Wot, Wot
Wot, Wot, Wot, Wot, Wot, Wot, Wot, Wot, Wot, Wot, Wot, Wot, Wot, Wot, Wot, Wot, Wot, Wot, Wot, Wot, Wot, Wot, Wot, Wot, Wot, Wot, Wot, Wot, Wot, Wot, Wot, Wot, Wot, Wot, Wot, Wot, Wot, Xu, Xu, Zwb, Zwh, Xu, Xu, Xu, Wwf, Xu, Wwf, Uh, Wwf, Xu, Xu, Wot, Wot, Wot, Wot
Wot, Wot, Wot, Wot, Wot, Wot, Wot, Wot, Wot, Wot, Wot, Wot, Wot, Wot, Wot, Wot, Wot, Wot, Wot, Wot, Wot, Wot, Wot, Wot, Wot, Wot, Wot, Wot, Wot, Wot, Wot, Wot, Wot, Wot, Wot, Wot, Wot, Wot, Wot, Xu, Zwh, Zws, Xu, Ww, Xu, Uh, Xu, Ww, Xu, Uh, Wwg, Xu, Wot, Wot, Wot
Wot, Wot, Wot, Wot, Wot, Wot, Wot, Wot, Wot, Wot, Wot, Wot, Wot, Wot, Wot, Wot, Wot, Wot, Wot, Wot, Wot, Wot, Wot, Wot, Wot, Wot, Wot, Wot, Wot, Wot, Wot, Wot, Wot, Wot, Wot, Wot, Wot, Wot, Wot, Xu, Xu, Zwh, Xu, Wwf, Xu, Xu, Wot, Xu, Wot, Xu, Xu, Wot, Wot, Wot, Wot
Wot, Wot, Wot, Wot, Wot, Wot, Wot, Wot, Wot, Wot, Wot, Wot, Wot, Wot, Wot, Wot, Wot, Wot, Wot, Wot, Wot, Wot, Wot, Wot, Wot, Wot, Wot, Wot, Wot, Wot, Wot, Wot, Wot, Wot, Wot, Wot, Wot, Wot, Wot, Xu, Zwh, Zws, Xu, Ww, Xu, Wot, Wot, Wot, Wot, Wot, Wot, Wot, Wot, Wot, Wot
Wot, Wot, Wot, Wot, Wot, Wot, Wot, Wot, Wot, Wot, Wot, Wot, Wot, Wot, Wot, Wot, Wot, Wot, Wot, Wot, Wot, Wot, Wot, Wot, Wot, Wot, Xu, Xu, Xu, Xu, Xu, Xu, Xu, Wot, Wot, Wot, Wot, Wot, Wot, Xu, Zwh, Xu, Xu, Wwf, Wwf, Xu, Wot, Wot, Wot, Wot, Wot, Wot, Wot, Wot, Wot
Wot, Wot, Wot, Wot, Wot, Wot, Xu, Xu, Xu, Xu, Xu, Xu, Xu, Wot, Wot, Wot, Wot, Wot, Wot, Wot, Wot, Wot, Wot, Wot, Wot, Xu, Zws, Zwh, Zws, Zwh, Zws, Zwh, Zws, Xu, Xu, Wot, Wot, Wot, Wot, Xu, Xu, Zws, Xu, Uu, Xu, Xu, Xu, Wot, Wot, Wot, Wot, Wot, Wot, Wot, Wot
Wot, Wot, Wot, Wot, Xu, Xu, Zws, 2 Zws, Zwh, 1 Zws, Zws, Zwh, Zws, Xu, Xu, Wot, Wot, Wot, Wot, Wot, Wot, Wot, Wot, Wot, Xu, Xu, Zwh, Zws, Zws, Zws, Zws, Zwh, Zws, Zws, Zwh, Xu, Wot, Wot, Wot, Xu, Zws, Zwh, Zwh, Zws, Zwh, Xu, Xu, Wot, Wot, Wot, Wot, Wot, Wot, Wot, Wot
Wot, Wot, Wot, Wot, Xu, Zwh, Xu, Xu, Xu, Zws, Zws, Zwh, Zws, Zws, Zwh, Xu, Xu, Wot, Wot, Wot, Wot, Wot, Wot, Wot, Xu, Zws, Zws, Zwh, Zwh, Zws, Zws, Zwh, Zws, Zws, Zwh, Xu, Xu, Wot, Xu, Xu, Zwh, Zws, Zws, Xu, Zwh, Zws, Zws, Xu, Wot, Wot, Wot, Wot, Wot, Wot, Wot
Wot, Wot, Wot, Wot, Xu, Zws, Xu, Wot, Xu, Zws, Zws, Zws, Xu, Zwh, Zws, Zws, Xu, Wot, Wot, Wot, Wot, Wot, Wot, Xu, Xu, Zws, Zws, Zws, Zwh, Zws, Zws, Zwh, Zws, Zws, Zwh, Zws, Zwh, Xu, Zwh, Zws, Zws, Zwh, Zwh, Zws, Zws, Zwh, Zws, Xu, Wot, Wot, Wot, Wot, Wot, Wot, Wot
Wot, Wot, Wot, Wot, Xu, Zws, Xu, Wot, Wot, Xu, Xu, Xu, Wot, Xu, Xu, Zws, Zwh, Xu, Xu, Wot, Xu, Wot, Xu, Xu, Zwh, Zws, Zws, Zws, Zwh, Zws, Zws, Zwh, Zws, Zws, Zwh, Zws, Zwh, Zws, Zws, Zwh, Zws, Zws, Zwh, Zws, Zws, Zwh, Zws, Xu, Wot, Wot, Wot, Wot, Wot, Wot, Wot
Wot, Wot, Wot, Wot, Wot, Xu, Xu, Wot, Wot, Wot, Wot, Wot, Wot, Wot, Xu, Zwh, Zws, Zws, Zwh, Xu, Zws, Xu, Zws, Zws, Zws, Zwh, Zws, Zws, Xu, Xu, Xu, Zwh, Xu, Zwh, Zws, Zws, Zws, Zwh, Zws, Zwh, Zwh, Zws, Zws, Zwh, Zws, Zwh, Zwh^Dr, Xu, Wot, Wot, Wot, Wot, Wot, Wot, Wot
Wot, Wot, Wot, Wot, Wot, Xu, Xu, Xu, Xu, Wot, Wot, Wot, Wot, Wot, Wot, Xu, Zws, Zws, Zwh, Zws, Zws, Zwh, Zws, Zws, Zws, Zwh, Zws, Xu, Wot, Wot, Wot, Xu, Wot, Xu, Xu, Zws, Zwh, Zwh, Zws, Zws, Zwh, Zws, Zws, Zwh, Zws, Zws, Xu, Xu, Wot, Wot, Wot, Wot, Wot, Wot, Wot
Wot, Wot, Wot, Wot, Wot, Wot, Wot, Xu, Xu, Wot, Wot, Wot, Wot, Wot, Wot, Xu, Xu, Zwh, Zws, Zws, Zws, Zwh, Zws, Zws, Zws, Zwh, Xu, Xu, Wot, Wot, Wot, Wot, Wot, Wot, Xu, Zwh^Dr, Zws, Zws, Zws, Zws, Zwh, Zws, Zws, Zwh, Zws, Zwh, Xu, Wot, Wot, Wot, Wot, Wot, Wot, Wot, Wot
Wot, Wot, Wot, Wot, Wot, Wot, Wot, Wot, Wot, Wot, Wot, Wot, Wot, Wot, Wot, Wot, Wot, Xu, Xu, Zwh, Xu, Zwh, Xu, Xu, Xu, Xu, Wot, Wot, Wot, Wot, Wot, Wot, Wot, Wot, Wot, Xu, Xu, Zwh, Zws, Zwh, Zws, Zws, Zwh, Zwh, Zws, Zws, Xu, Wot, Wot, Wot, Wot, Wot, Wot, Wot, Wot
Wot, Wot, Wot, Wot, Wot, Wot, Wot, Wot, Wot, Wot, Wot, Wot, Wot, Wot, Wot, Wot, Wot, Wot, Wot, Xu, Wot, Xu, Wot, Wot, Wot, Wot, Wot, Wot, Wot, Wot, Wot, Wot, Wot, Wot, Wot, Wot, Wot, Xu, Xu, Xu, Xu, Zwh, Xu, Zwh^Dr, Xu, Xu, Wot, Wot, Wot, Wot, Wot, Wot, Wot, Wot, Wot
Wot, Wot, Wot, Wot, Wot, Wot, Wot, Wot, Wot, Wot, Wot, Wot, Wot, Wot, Wot, Wot, Wot, Wot, Wot, Wot, Wot, Wot, Wot, Wot, Wot, Wot, Wot, Wot, Wot, Wot, Wot, Wot, Wot, Wot, Wot, Wot, Wot, Wot, Wot, Wot, Wot, Xu, Wot, Xu, Wot, Wot, Wot, Wot, Wot, Wot, Wot, Wot, Wot, Wot, Wot
Wot, Wot, Wot, Wot, Wot, Wot, Wot, Wot, Wot, Wot, Wot, Wot, Wot, Wot, Wot, Wot, Wot, Wot, Wot, Wot, Wot, Wot, Wot, Wot, Wot, Wot, Wot, Wot, Wot, Wot, Wot, Wot, Wot, Wot, Wot, Wot, Wot, Wot, Wot, Wot, Wot, Wot, Wot, Wot, Wot, Wot, Wot, Wot, Wot, Wot, Wot, Wot, Wot, Wot, Wot
Wot, Wot, Wot, Wot, Wot, Wot, Wot, Wot, Wot, Wot, Wot, Wot, Wot, Wot, Wot, Wot, Wot, Wot, Wot, Wot, Wot, Wot, Wot, Wot, Wot, Wot, Wot, Wot, Wot, Wot, Wot, Wot, Wot, Wot, Wot, Wot, Wot, Wot, Wot, Wot, Wot, Wot, Wot, Wot, Wot, Wot, Wot, Wot, Wot, Wot, Wot, Wot, Wot, Wot, Wot
