Wog, Ww, Ww, Ww, Ww, Ww, Ww, Ww, Ww, Ww, Ww, Ww, Ww, Ww, Wog, Wog, Wog, Wo
Wog, Ww, Ww, Ww, Ww, Ww, Ww, Ww, Ww, Ww, Ww, Ww, Ww, Ww, Wog, Wog, Ww, Wog
Wog, Wog, Ww, Ww, Wog, Ww, Wog, Wog, Ww, Ww, Ww, Ww, Ww, Ww, Ww, Wog, Wog, Wog
Ww, Ww, Ww, Ww, Ww, Ww, Ww, Ww, Ww, Ww, Ww, Ww, Wwr, Ww, Ww, Ww, Ww, Wog
Ww, Ww, Wog, Ww, Ww, 1 Ww, Ww, 2 Ww, Ww, Ww, Ww, Wwr, Ww, Ww, Ww, Ww, Ww, Ww
Wog, Wog, Ww, Ww, Ww, Ww, Ww, Ww, Ww, Ww, Ww, Ww, Wog^Edt, Wwr, Wwr, Ww, Wwr, Ww
Ww, Ww, Ww, Ww, Ww, Ww, Wwr, Ww, Wog^Edt, Wwr, Wwf^Es, Ww, Ww, Wog^Edt, ZWCe^Edb, Ww, Ww, Wog
Wwr, Wwr, Ww, Wog^Edt, Wog^Edb, Wwr^Edb, ZWCe^Es, Ww, Wwf^Es, Wwf^Dr, Mm, Wog^Edt, ZWCe^Es, Wwr, Wog^Edt, Ww, Ww, Wwr
Wwr, Wwr, Ww, Wog^Edt, ZWCe^Edb, ZWCe, ZWCe, Wwr, Mm, Mm^Xm, Wwf^Edt, Ww, ZWCe^Es, ZWCe^Edb, ZWCe, Ww, Ww, Wwr
Wog, Wog, Wog^Edt, ZWCe^Edb, ZWCe^Es, Wwr^Edb, ZWCe, Wwf^Edb, Wwr, Wwf^Es, ZWCe^Edb, Mm, Wwf^Edb, ZWCe^Edb, Wwr^Edt, ZWKe, Wog, Ww
Ww, Ww, Ww, ZWCe, ZWCe, ZWCe, Wog^Edt, Ww, Wwr, ZWCe, Wog^Edt, Mm, ZWCe, ZWCe, ZWKe, ZWKe, Ww, Ww
Ww, Wog^Edt, Ww, Wog^Edb, Ww, Ww, Ww, Ww, Ww, Ww, Wog, Wog^Edt, Ww, ZWKe, Ww, Wog, Wwr, Wwr
Wog, Ww, Ww, Ww, Ww, Ww, Ww, Wog, Ww, Ww, Ww, Ww, Ww, Ww, Ww, Ww, Ww, Ww
