border_size=1
usage=map

Wo, Wo, Wo, Wo, Wo, Wo, Wo, Wo, Wo, Wo, Wo, Wo, Wo, Wo, Wo, Wo, Wo, Wo
Wo, Wo, Wo, Wo, Wo, Wo, Wo, Wo, Wo, Wo, Wo, Wo, Wo, Wo, Wo, Wo, Wo, Wo
Wo, Wo, Wo, Wo, Wo, Wo, Wo, Wo, Wo, Wo, Wo, Wo, Wo, Wo, Wo, Wo, Wo, Wo
Wo, Wo, Wo, Wo, Wo, Wo, Ww, Ww, Ww, Ww, Ww, Ww, Ww, Wo, Wo, Wo, Wo, Wo
Wo, Wo, Wo, Wo, Ww, 1 Ww, Ww, 2 Ww, Ww, Ww, Ww, Wo, Ww, Wo, Ww, Wo, Wo, Wo
Wo, Wo, Wo, Ww, Ww, Ww, Ww, Ww, Ww, Ww, Wo, Ww, Ww, Ww, Ww, Wo, Wo, Wo
Wo, Wo, Ww, Ww, Ww, Ww, Ww, Ww, Ww, Ww, Ww, Wo, Ww, Wo, Ww, Wo, Wo, Wo
Wo, Wo, Ww, Wo, Ww, Wo, ZWKe, Ww, ZWKe, Ww, ZWKe, Ww, ZWKe, Ww, ZWKe, Ww, Wo, Wo
Wo, Wo, Wo, Ww, ZWCe, ZWCe, ZWCe, ZWCe, ZWCe, ZWCe, ZWCe, ZWCe, ZWCe, ZWCe, ZWCe, ZWKe, Wo, Wo
Wo, Wo, ZWKe, ZWKe, ZWCe, ZWCe, ZWf^Zwv, ZWf, ZWf^Zwv, ZWf, ZWf^Zwv, ZWCe, 4 ZWCe^Zwk, ZWCe, ZWKe, ZWKe, Wo, Wo
Wo, Wo, Wo, ZWKe, ZWCe, ZWCe, ZWCe, ZWf, ZWCe, ZWf, ZWCe, ZWCe, ZWCe, ZWCe, ZWCe, ZWKe, Wo, Wo
Wo, Wo, Wo, Wo, Wo, ZWCe, ZWKe, ZWCe, ZWKe, ZWCe, ZWKe, ZWCe, ZWKe, ZWCe, ZWKe, ZWKe, Wo, Wo
Wo, Wo, Wo, Wo, Wo, Wo, Wo, Wo, Wo, Wo, Wo, Wo, Wo, Wo, Wo, Wo, Wo, Wo
Wo, Wo, Wo, Wo, Wo, Wo, Wo, Wo, Wo, Wo, Wo, Wo, Wo, Wo, Wo, Wo, Wo, Wo
