Wog, Wog, Wog, Wog, Wog, Wog, Wog, Wog, Wog, Wog, Wog, Wog, Wog, Wog, Wog, Wwg, Wwg, Wo
Wwg, Wog, Wwg, Wog, Wog, Wog, Wog, Wog, Wog, Wog, Wog, Wog, Wog, Wog, Wog, Wwg, Wwg, Wwg
Wwg, Wwg, Wwg, Wwg, Wwg, Wog, Wog, Wog, Wog, Wog, Wog, Wog, Wog, Wog, Wwg, Wwg, Wwg, Wwg
Wog, Wwg, Wog, Wwg, Wog, Wog, Wwg, Wog, Wwg, Wog, Wwg, Wog, Wog, Wwg, Wwg, Wwg, Wwg, Wwg
Wog, Wog, Wog, Wog, Wwg, 1 Wwg, Wwg, 2 Wwg, Wwg, Wwg, Wwg, Wwg, Wwg, Wog, Wog, Wog, Wwrg, Wog
Wog, Wwg, Wwg, Wwg, Wwg, Wwg, Wwrg, Wwg, Wwg, Wwg, Wwg, Wwg, Wwg^Zro, Wwg, Wwrg, Wog, Wog, Wog
Wwg, Wog, Wwg, Wwg, Wwg^Zro, Wwrg, Wwf, Wwrg, Wwrg, Wwg, Wwrg, Wwrg, Wwrg, Wwg, Wwg, Wog, Wwrg, Wog
Wwg, Wwrg, Wwg, Wwg, Wwr, Wwrg, ZWCe, Wwf, Sm^Edt, Wwrg, ZWCe, Wwf, ZWKe, Wwrg, Wwg^Zro, Wwg, Wwg, Wog
Wwg, Wwg, Wwg^Zro, Wwrg, Sm^Edt, Sm^Edt, ZWCe, ZWCe, ZWCe, ZWCe, ZWCe, Sm^Edt, ZWKe, Wwrg, Wwg, Wwrg, Wwrg, Wwrg
Wwg, Wog, Wwrg, ZWCe, ZWCe, Wwf, ZWCe, ZWCe^Zwv, ZWCe, ZWCe, ZWCe, ZWCe^Zwk, Sm^Edt, Wwf, Wwrg, Wog, Wog, Wog
Wwrg, Wwrg, Wwrg, Wwg^Zro, Wwrg, ZWCe, ZWCe, Wwg^Zro, ZWCe, ZWCe, ZWCe, Rb^Edt, ZWKe, Wwf, Wwg, Wog, Wwg, Wog
Wog, Wwrg, Wwrg, Wwrg, Wwg, 4 Wwrg, Wwrg, Wwrg, Wwrg, Wwrg, Wwr, Wwrg, Wwg, Wwg^Zro, Wwg, Wwg, Wwrg, Wwrg
Wwrg, Wog, Wog, Wwrg, Wwrg, Wwrg, Wwrg, Wwrg, Wwrg, Wwrg, Wwr, Wwr, Wo, Wwg, Wwrg, Wwrg, Wwrg, Wwrg
