border_size=1
usage=map

Wo, Wo, Wo, Wo, Wo, Wo, Wo, Wo, Wo, Wo, Wo, Wo, Wo, Wo, Wo, Wo, Wo, Wo
Wo, Wo, Wo, Wo, Wo, Wo, Wo, Wo, Wo, Wo, Wo, Wo, Wo, Wo, Wo, Wo, Wo, Wo
Wo, Wo, Wo, Wo, Wo, Wo, Wo, Wo, Wo, Wo, Wo, Wo, Wo, Wo, Wo, Wo, Wo, Wo
Wo, Wo, Wo, Wo, Wo, Wo, Ww, Wo, Ww, Wo, Ww, Wo, Wo, Wo, Wo, Wo, Wo, Wo
Wo, Wo, Wo, Wo, Ww, 1 Ww, Ww, 2 Ww, Ww, Ww, Ww, Ww, Ww, Wo, Wo, Wo, Wo, Wo
Wo, Wo, Ww, Ww, Ww, Ww, Wo, Ww, Wo, Ww, Ww, Wo, Ww, Ww, Ww, Wo, Wo, Wo
Wo, Wo, Ww, Ww, Wo, Ww, Ww, Ww, Ww, Ww, Ww, Ww, Ww, Wo, Ww, Wo, Wo, Wo
Wo, Wo, Wo, Ww, Ww, Ww, ZWKe, Ww^ZBw|, ZWKe, Ww^ZBw|, ZWKe, Ww, ZWKe, Ww, ZWKe, Wo, Wo, Wo
Wo, Wo, Wo, Ww, ZWCe, ZWKe, Zfsb, ZWCe, Zfsb, ZWCe, Zfsb, ZWKe, ZWKe, ZWCe, Zfsb, ZWKe, Wo, Wo
Wo, Wo, ZWCe, ZWCe, Zfsb, Zfsb, Zfsb, Zfsb, Zfsb, Zfsb, Zfsb, Zfsb, Zfsb, Zfsb, ZWCe^Zwk, ZWCe, Wo, Wo
Wo, Wo, Wo, ZWCe, ZWCe, Zfsb, Zfsb, Zfsb, Zfsb, Zfsb, Zfsb, Zfsb, ZWKe, Zfsb, Zfsb, ZWCe, Wo, Wo
Wo, Wo, Wo, Wo, Wo, ZWKe, ZWKe, ZWCe, ZWKe, ZWCe, ZWKe, ZWKe, ZWKe, ZWCe, ZWKe, ZWKe, Wo, Wo
Wo, Wo, Wo, Wo, Wo, Wo, Wo, Wo, Wo, Wo, Wo, Wo, Wo, Wo, Wo, Wo, Wo, Wo
Wo, Wo, Wo, Wo, Wo, Wo, Wo, Wo, Wo, Wo, Wo, Wo, Wo, Wo, Wo, Wo, Wo, Wo
