Wog, Wog, Wog, Wog, Wog, Wog, Wog, Wog, Wog, Wog, Wog, Wog, Wog, Wog, Wog, Ss, Wwg^Fdw, Wo
Ss, Wog, Ss, Wog, Wog, Wog, Wog, Wog, Wog, Wog, Wog, Wog, Wog, Wog, Wog, Wwrg, Ss^Fdw, Ss^Fdw
Wwrg, Ss, Wwg, Ss, Wwg, Wog, Wog, Wog, Wog, Wog, Wog, Wog, Wog, Wog, Wwrg, Ss, Uu, Ss
Wog, Wwrg, Wog, Wwg, Wog, Wog, Wwg, Wog, Wwg, Wog, Wwg, Wog, Wwg, Wwg, Wwg, Wwrg, Wwrg, Ss
Wog, Wog, Wog, Wog, Wwg, 1 Wwg, Wwg, 2 Wwg, Wwg, Wwg, Wwg, Wwg, Wwg, Wog, Wog, Wog, Wwg, Wog
Wog, Ss, Wwg, Wwg, Wwg, Wwg, Wwg, Wwg, Wwg, Wwg, Wwg, Wwg, Wwg, Wwg, Wwrg, Wwg, Wog, Wog
Ss, Wog, Ss, Wwg, Wwg, Wwg, Wwg, Wwg, Wwg, Wwg, Wwg, Wwg, Wwg, Wwg, Wwrg, Wwrg, Wwrg, Wog
Ss^Fdw, Ss, Wwg, Wwg, Ss, Wwg, Ww^ZBw|, Wwg, Ww^ZBw|, Wwg, Ww^ZBw|, Wwg, Wwrg, Wwrg, Wwg^Fdw, Wwrg, Wwrg, Wog
Ss^Fdw, Ss^Fdw, Ss, Wwg, ZWCe, ZWCe^Fdw, ZWCe, ZWCe, ZWCe, ZWCe^Fdw, Uu, Qxu, ZWKe, Wwg^Fdw, Wwg^Fdw, Wwrg, Wwrg, Wwrg
Wwg, Wwg^Fdw, Ss, ZWCe^Fdw, ZWCe^Fdw, ZWCe, ZWCe, ZWf^Zwv, Qxu, ZWf^Zwv, Uu, Qxu, ZWKe, Ss, Wog, Wog, Wog, Wog
Wwrg, Wwrg, Wwrg, Ss^Fdw, Wwrg, Uu^Fdw, Wwg^Fdw, Qxu, Ss, Uu, Ss, ZWCe, Ss, Ss^Fdw, Ss^Fdw, Wog, Wwrg, Wog
Wog, Wwrg, Wwrg, Wwrg, Wwrg, Wwrg, Wwrg, Wog, Wog, Wwg^Fdw, Wwr, Wwr, Ss, Ss, Wwg^Fdw, Wog^Fdw, Wwrg, Wwrg
Wwrg, Wog, Wog, Wwrg, Wwrg, Wwrg, Wwrg, Wwrg, Wwrg, Wwrg, Wwr, Wwr, Wo, Ss, Wwrg, Wwrg, Wwrg, Wwrg
