Ww, Wo, Wo, Wo, Ww, Wo, Ww, Wo, Wo, Wo, Ww, Wo, Wo, Wo, Ww, Wo, Ww, Wo
Ww, Ww, Wo, Wo, Wo, Ww, Wo, Wo, Wo, Wo, Wo, Wo, Wo, Wo, Wo, Ww, Wo, Ww
Ww, Wo, Ww, Ww, Ww, Wo, Ww, Ww, Ww, Ww, Ww, Ww, Ww, Ww, Ww, Wo, Wo, Ww
Wo, Wo, Ww, Ww, Ww, Ww, Ww, Ww, Ww, Ww, Ww, Ww, Ww, Ww, Ww, Wo, Wo, Wo
Wo, Wo, Ww, Ww, Ww, 1 Ww, Ww, 2 Ww, Ww, Ww, Ww, Ww, Ww, Ww, Ww, Ww, Wo, Wo
Wo, Wo, Ww, Ww, Ww, Ww, Ww, Ww, Ww, Ww, Ww, Ww, Ww, Ww, Ww, Wo, Wo, Ww
Wo, Wo, Ww, Ww, Wo, Ww, Ww, Ww, Ww, Ww, Ww, Ww, Ww, Wo, Ww, Wo, Wo, Ww
Wo, Wo, Wo, Ww, Ww, Ww, Ww, Ww, Ww, Ww, ZWCe, Ww, ZWCe, Ww, Ww, Wo, Wo, Wo
Wo, Ww, ZWCe, ZWCe, ZWCe, ZWCe, ZWCe, Ww, Ww, ZWCe, ZWf^Zwv, ZWCe, ZWKe, ZWCe, ZWCe, Ww, Wo, Wo
Wo, Wo, ZWCe, ZWf^Zwv, ZWCe, ZWKe, ZWCe, ZWCe, Ww, ZWCe, ZWCe, ZWCe, ZWCe, ZWCe, Ww, Wo, Wo, Ww
Wo, Ww, Ww, ZWCe, Ww, ZWCe, Ww, Ww, Ww, Ww, Ww, Ww, Ww, Ww, Wo, Wo, Ww, Ww
Wo, Ww, Wo, Ww, Wo, Ww, ZWCe, Ww^ZBw|, ZWCe, Ww^ZBw|, ZWCe, Ww^ZBw|, ZWKe, Wo, Wo, Wo, Wo, Wo
Wo, Wo, Wo, Ww, ZWCe, ZWKe, ZWCe, ZWCe, ZWCe, ZWCe, ZWCe, ZWCe, ZWCe, ZWKe, Wo, Wo, Wo, Wo
Wo, Wo, Wo, ZWCe, ZWCe, ZWCe, ZWCe, ZWf^Zwv, ZWCe, ZWf^Zwv, ZWCe, 4 ZWCe^Zwk, ZWCe, ZWKe, Wo, Wo, Ww, Ww
Wo, Ww, Wo, Wo, Ww, ZWKe, ZWCe, ZWCe, ZWCe, ZWCe, ZWCe, ZWCe, ZWKe, ZWKe, Wo, Wo, Ww, Wo
Wo, Wo, Wo, Wo, Wo, Ww, Wo, Wo, Wo, Wo, Wo, Wo, Wo, Wo, Wo, Wo, Ww, Wo
Wo, Wo, Ww, Wo, Wo, Ww, Ww, Wo, Wo, Wo, Wo, Wo, Wo, Wo, Wo, Ww, Wo, Wo
Wo, Ww, Ww, Wo, Ww, Wo, Wo, Ww, Wo, Ww, Wo, Wo, Ww, Ww, Wo, Wo, Wo, Ww
Ww, Ww, Wo, Wo, Wo, Wo, Wo, Wo, Wo, Ww, Wo, Wo, Wo, Wo, Ww, Ww, Wo, Wo
Wo, Ww, Wo, Wo, Wo, Ww, Wo, Wo, Wo, Wo, Wo, Wo, Wo, Wo, Wo, Wo, Wo, Wo
