Wo, Wo, Wo, Wo, Wo, Wo, Wo, Wo, Wo, Wo, Wo, Wo, Wo, Wo, Wo, Wo, Wo, Wo
Wo, Wo, Wo, Wo, Wo, Wo, Wo, Wo, Wo, Wo, Wo, Wo, Wo, Wo, Wo, Wo, Wo, Wo
Wo, Wo, Wo, Wo, Wo, Wo, Wo, Wo, Wo, Wo, Wo, Wo, Wo, Wo, Wo, Wo, Wo, Wo
Wo, Wo, Wo, Wo, Wo, Wo, Ww, Ww, Ww, Ww, Ww, Ww, Ww, Wo, Wo, Wo, Wo, Wo
Wo, Wo, Wo, Wo, Ww, 1 Ww, Ww, 2 Ww, Ww, Ww, Ww, Wo, Ww, Wo, Ww, Wo, Wo, Wo
Wo, Wo, Wo, Ww, Ww, Ww, Ww, Ww, Ww, Ww, Wo, Ww, Ww, Ww, Ww, Wo, Wo, Wo
Wo, Wo, Ww, Ww, Ww, Ww, Ww, Ww, Ww, Ww, Ww, Wo, Ww, Wo, Ww, Wo, Wo, Wo
Wo, Wo, Ww, Wo, Ww, Wo, Wwf^Edt, Ww, ZWKe, Ww^Edb, ZWKe, Ww^Edt, ZWKe^Edt, Ww^Edt, ZWKe^Edb, Ww, Wo, Wo
Wo, Wo, Wo, Ww^Edb, ZWCe^Edb, ZWCe, ZWCe^Edb, ZWCe, Wwrg, Wwrg, ZWCe, ZWCe, ZWCe^Edb, ZWCe, Wwf^Edt, ZWCe, Wo, Wo
Wo, Wo, ZWKe, ZWKe, ZWCe^Edt, ZWCe, Wwf^Edt, Ww^Edt, Wwrg, Ww^Edt, Wwf^Edt, ZWCe, 4 ZWCe^Zwk, ZWCe, ZWKe, Wwf^Edt, Wo, Wo
Wo, Wo, Wo^Edb, ZWKe^Edt, Wwf^Edt, ZWCe, ZWCe, Ww, Wwrg, Ww, ZWCe^Edb, ZWCe, ZWCe, ZWCe, ZWCe, ZWKe^Edt, Wo, Wo
Wo, Wo, Wo, Ww^Edb, Ww, ZWCe, Ww^Edt, Wwrg, ZWKe, ZWCe, ZWCe^Edb, ZWCe, Wwf^Edt, ZWCe^Edt, ZWKe, ZWKe, Wo, Wo
Wo, Wo, Wo, Wo, Wo, Wwrg, Wo, Wo^Edt, Wo, Wo, Wo, Wo^Edt, Wo, Wo, Wo, Wo, Wo, Wo
Wo, Wo, Wo, Wo, Wo, Wo, Wo, Wo, Wo, Wo, Wo, Wo, Wo, Wo, Wo, Wo, Wo, Wo
