border_size=1
usage=map

Wo, Wo, Wo, Wo, Wo, Wo, Wo, Wo, Wo, Wo, Wo, Wo, Wo, Wo, Wo, Wo, Wo, Wo
Wo, Wo, Wo, Wo, Wo, Wo, Wo, Wo, Wo, Wo, Wo, Wo, Wo, Wo, Wo, Wo, Wo, Wo
Wo, Wo, Wo, Wo, Wo, Wo, Wo, Wo, Wo, Wo, Wo, Wo, Wo, Wo, Wo, Wo, Wo, Wo
Wo, Wo, Wo, Wo, Wo, Wo, Ww, Wo, Ww, Wo, Ww, Wo, Wo, Wo, Wo, Wo, Wo, Wo
Wo, Wo, Wo, Wo, Ww, 1 Ww, Ww, 2 Ww, Ww, Ww, Ww, Ww, Ww, Wo, Wo, Wo, Wo, Wo
Wo, Wo, Ww, Ww, Ww, Ww, Wo, Ww, Wo, Ww, Ww, Wo, Ww, Ww, Ww, Wo, Wo, Wo
Wo, Wo, Ww, Ww, Wo, Ww, Ww, Ww, Ww, Ww, Ww, Ww, Ww, Wo, Ww, Wo, Wo, Wo
Wo, Wo, Wo, Ww, Ww, Ww, ZWCe, Ww^ZBw|, ZWCe, Ww^ZBw|, ZWCe, Ww^ZBw|, ZWKe, Ww, Ww, Wo, Wo, Wo
Wo, Wo, Wo, Ww, ZWCe, ZWKe, ZWCe, ZWCe, ZWCe, ZWCe, ZWCe, ZWCe, ZWCe, ZWKe, Wo, Wo, Wo, Wo
Wo, Wo, Wo, ZWCe, ZWCe, ZWCe, ZWCe, ZWf^Zwv, ZWCe, ZWf^Zwv, ZWCe, 4 ZWCe^Zwk, ZWCe, ZWKe, Wo, Wo, Wo, Wo
Wo, Wo, Wo, Wo, Wo, ZWKe, ZWCe, ZWCe, ZWCe, ZWCe, ZWCe, ZWCe, ZWKe, ZWKe, Wo, Wo, Wo, Wo
Wo, Wo, Wo, Wo, Wo, Wo, Wo, Wo, Wo, Wo, Wo, Wo, Wo, Wo, Wo, Wo, Wo, Wo
Wo, Wo, Wo, Wo, Wo, Wo, Ww, Wo, Wo, Wo, Wo, Wo, Wo, Wo, Wo, Wo, Wo, Wo
