border_size=1
usage=map

_off^_usr, _off^_usr, _off^_usr, _off^_usr, _off^_usr, _off^_usr, _off^_usr, _off^_usr, _off^_usr, _off^_usr, _off^_usr, _off^_usr, _off^_usr, _off^_usr, _off^_usr, _off^_usr, _off^_usr, _off^_usr, Wwt, Wot, Wot, Wot, Wot, Wot, Wot, Wwt, Gd, Gd, Gll^Fmf, Gll^Fmf, Gll^Fmf, Gll^Fmf, Gll^Fmf, Gll^Fmf, Gll^Fmf, Gll^Fmw, Gll^Fmw, Gll^Fmw, Mm, Gll^Fmw, Gll^Fmw, Gs, Gll^Fmf, Gs, Gs, Gd, Gd, Ds, Wot, Wot, Wot, Ww, Wot, Wwt, Wwt, Wwt, Wot, Gd, Gd, Gd
_off^_usr, _off^_usr, _off^_usr, _off^_usr, _off^_usr, _off^_usr, _off^_usr, _off^_usr, _off^_usr, _off^_usr, _off^_usr, _off^_usr, _off^_usr, _off^_usr, _off^_usr, _off^_usr, _off^_usr, _off^_usr, Wwt, Wwt, Wot, Wot, Wot, Wot, Wwt, Wwt, Ds, Gd, Gd, Gd, Gll^Fmf, Gs, Gd, Gd, Gll^Fmf, Gd, Gll^Fmf, Gll^Fmf, Gll^Fmf, Gll^Fmw, Gll^Fmw, Gll^Fmf, Gll^Fmf, Gs, Gd, Gd, Ds, Wot^Vm, Wot, Wot, Wwt, Wot, Wot, Wot, Wwt, Wwt, Wot^Vm, Gd, Gd, Gd
_off^_usr, _off^_usr, _off^_usr, _off^_usr, _off^_usr, _off^_usr, _off^_usr, _off^_usr, _off^_usr, _off^_usr, _off^_usr, _off^_usr, _off^_usr, _off^_usr, _off^_usr, _off^_usr, _off^_usr, _off^_usr, Wot, Wot, Wot, Wot, Wot, Wwt, Wwt, Wwt, Wwt, Ds, Gd, Gd, Gd, Gll^Fmf, Gd, Gd, Gd, Gd, Gs, Mm, Gll^Fmf, Gll^Fmw, Gs^Fms, Gll^Fmf, Gll^Fmf, Gd, Ds, Ds, Wot, Wwt, Wwt, Wwt, Wwt, Wwt, Wwt, Wot, Wwt, Wwt, Wot, Ds, Gd, Gd
_off^_usr, _off^_usr, _off^_usr, _off^_usr, _off^_usr, _off^_usr, _off^_usr, _off^_usr, _off^_usr, _off^_usr, _off^_usr, _off^_usr, _off^_usr, _off^_usr, _off^_usr, _off^_usr, _off^_usr, _off^_usr, Wot, Wot, Wwt, Wwt, Wwt, Wwt, Wot, Wot, Wwt, Wwt, Wwt, Wot^Vm, Wot, Gd, Wwt, Ds, Ds, Gd, Gd, Gd, Gll^Fmf, Gll^Fmw, Wwt, Gll^Fmf, Gll^Fmf, Gd, Ds, Wwt, Wwt, Wwt, Wot, Wwt, Wwt, Wwt, Wwt, Wot, Wot, Wot, Wwt, Ds, Gd, Gd
_off^_usr, _off^_usr, _off^_usr, _off^_usr, _off^_usr, 1 _off^_usr, _off^_usr, 2 _off^_usr, _off^_usr, _off^_usr, _off^_usr, _off^_usr, _off^_usr, _off^_usr, _off^_usr, _off^_usr, _off^_usr, _off^_usr, Wot, Wot, Wot, Wwt, Wot, Wot, Wwt, Wwt, Wot, Wot, Wot, Wwt, Wwt, Wwt, Wwt, Wwt, Ds, Gd, Gd, Gll^Fmf, Gd, Gll^Fmf, Gll^Fmf, Gll^Fmf, Gd, Gd, Ds, Wwt, Wot, Wot, Wwt, Wwt, Wot, Wot, Wot, Wot, Wot, Wot, Wwt, Wot, Wot^Vm, Gd
_off^_usr, _off^_usr, _off^_usr, _off^_usr, _off^_usr, _off^_usr, _off^_usr, _off^_usr, _off^_usr, _off^_usr, _off^_usr, _off^_usr, _off^_usr, _off^_usr, _off^_usr, _off^_usr, _off^_usr, _off^_usr, Wot, Wot, Wot, Wot, Wot, Wot, Wwt, Wot, Wot, Wwt, Wwt, Wot, Wot, Wwt, Wwt, Wwt, Wwt, Ds, Ds, Gd, Gd, Gll^Fmf, Gd, Gs, Gll^Fmf, Gd, Ds, Wot, Wot, Wwt, Wwt, Wwt, Wwt, Wwt, Wwt, Wot, Wot, Wwt, Wot, Wwt, Wwt, Wwt
_off^_usr, _off^_usr, _off^_usr, _off^_usr, _off^_usr, _off^_usr, _off^_usr, _off^_usr, _off^_usr, _off^_usr, _off^_usr, _off^_usr, _off^_usr, _off^_usr, _off^_usr, _off^_usr, _off^_usr, _off^_usr, Wwt, Wwt, Wwt, Wwt, Wot, Wwt, Wwt, Wot, Wwt, Wwt, Wot, Wot, Wwt, Wot, Wot, Wwt, Wwt, Wwt, Wwt, Ds, Gd, Gd, Gd, Gll^Fmf, Gll^Fmf, Gd, Gd, Wwf, Wwt, Wot, Wot, Wwt, Wwt, Wot, Wot, Wot, Wot, Wot, Wot, Wwt, Wwt, Wwt
_off^_usr, _off^_usr, _off^_usr, _off^_usr, _off^_usr, _off^_usr, _off^_usr, _off^_usr, _off^_usr, _off^_usr, _off^_usr, _off^_usr, _off^_usr, _off^_usr, _off^_usr, _off^_usr, _off^_usr, _off^_usr, Wot, Wot, Wot, Wot, Wwt, Wwt, Wwt, Wwt, Wot, Wot, Wwt, Wwt, Wot, Wwt, Wwt, Wwt, Wot, Wwt, Wwt, Wwt, Wot, Gd, Gd, Gd, Gd, Gd, Gd, Wwf, Wot, Wwt, Wwt, Wwt, Wwt, Wot, Wot, Wwt, Wwt, Wwt, Wot, Wwt, Wwt, Wwt
_off^_usr, _off^_usr, _off^_usr, _off^_usr, _off^_usr, _off^_usr, _off^_usr, _off^_usr, _off^_usr, _off^_usr, _off^_usr, _off^_usr, _off^_usr, _off^_usr, _off^_usr, _off^_usr, _off^_usr, _off^_usr, Wwt, Wwt, Wwt, Wwt, Wot, Wwt, Wwt, Wot, Wwt, Wwr, Wwt, Wot, Wwt, Wwt, Wot, Wot, Wwt, Wwt, Wot, Wwt, Wwt, Wot, Wwt, Ds, Ds, Gd, Gll^Fmf, Gd, Gd, Wot, Wot, Wot, Wwt, Wwt, Wwt, Wwt, Wot, Wwt, Wwt, Wot, Wwt, Wwt
_off^_usr, _off^_usr, _off^_usr, _off^_usr, ZWKe, _off^_usr, ZWCe^Zca, _off^_usr, ZWCe, _off^_usr, ZWCe^Zca, _off^_usr, _off^_usr, _off^_usr, _off^_usr, _off^_usr, _off^_usr, _off^_usr, Wot, Wwt, Wwt, Wwt, Wwt, Wwr, Wwt, Wwt, Wwt, Wwt, Wwt, Wwt, Wwt, Wwt, Wwt, Wwt, Wot, Wwt, Wot, Wot, Wot, Wwt, Wwt, Wwt, Wwt, Gd, Gd, Gd, Gd, Wwf^Zlh, Wwt, Wot, Wot, Wwt, Wwt, Wwt, Wot, Wwt, Wwt, Wot, Wwt, Wwt
_off^_usr, _off^_usr, _off^_usr, ZWKe, ZWCe, ZWCe, ZWCe, ZWCe, ZWCe, ZWCe, ZWCe, ZWKe, ZWCe^Zmo, _off^_usr, _off^_usr, _off^_usr, _off^_usr, _off^_usr, Wot, Wot, Wwt, Wot, Wot, Wwt, Wot, Wwt, Wwt, Wwt, Wot, Wot, Wot, Wwt, Wot, Wwt, Wwt, Wwt, Wwt, Wot, Wot, Wot, Wwt, Wwt, Wwt, Wot, Wwt, Ds, Wwt, Wwt, Wwt, Wwt, Wot, Wwt, Wwt, Wwt, Wot, Wwt, Wwt, Wot, Wot, Wwt
_off^_usr, _off^_usr, _off^_usr, ZWKe, ZWCe, ZWCe^Zwk, ZWCe, ZWf^Zwv, ZWCe, ZWf^Zwv, ZWCe, 3 ZWCe^Zwk, ZWCe^Zba, ZWCe, _off^_usr, _off^_usr, _off^_usr, _off^_usr, Wwt, Wot, Wot, Wwt, Wwt, Wwt, Wwr, Wot, Wot, Wwt, Wwt, Wwr, Wwt, Wwt, Wwt, Wwt, Wot, Wwt, Wwt, Wot, Wot, Wwt, Wwt, Wwt, Wwt, Wwt, Wwt, Wwt, Wot, Wot, Wot, Wwt, Wot, Wwt, Wwt, Wot, Wot, Wwt, Wwt, Wwt, Wwt, Wwt
_off^_usr, _off^_usr, _off^_usr, ZWKe, ZWKe, ZWCe, ZWCe^Zca, ZWCe, ZWCe, ZWCe, ZWCe^Zca, ZWKe, _off^_usr, _off^_usr, _off^_usr, _off^_usr, _off^_usr, _off^_usr, Wot, Wwt, Wwt, Wot, Wwt, Wwr, Wwt, Wwt, Wwr, Wot, Wot, Wot, Wwg^Zro, Wwt, Wwt, Wwg^Zro, Wwt, Wot, Wwt, Wwt, Wwt, Wwt, Wot, Wot, Wwt, Wwt, Wwt, Wwt, Wwt, Wwt, Wot, Wwt, Wwt, Wwt, Wwt, Wot, Wot, Wot, Wot, Wwt, Wot, Wwt
_off^_usr, _off^_usr, _off^_usr, _off^_usr, _off^_usr, _off^_usr, _off^_usr, _off^_usr, _off^_usr, _off^_usr, _off^_usr, _off^_usr, _off^_usr, _off^_usr, _off^_usr, _off^_usr, _off^_usr, _off^_usr, Wot, Wot, Wot, Wwt, Wwr, Wwt, Wot, Wwg^Zro, Wwr, Wwr, Wwt, Wwt, Wwt, Wwg^Zro, Wot, Wwt, Wwr, Wwt, Wwt, Wwt, Wot, Wot, Wwt, Wwt, Wot, Wwt, Wwt, Wwt, Wwt, Wwt, Wwt, Wwt, Wwt, Wot, Wwt, Wwt, Wwt, Wot, Wot, Wwt, Wot, Wwt
_off^_usr, _off^_usr, _off^_usr, _off^_usr, _off^_usr, _off^_usr, _off^_usr, _off^_usr, _off^_usr, _off^_usr, _off^_usr, _off^_usr, _off^_usr, _off^_usr, _off^_usr, _off^_usr, _off^_usr, _off^_usr, Wot, Wot, Wot, Wot, Wwr, Wwr, Wot, Wot, Wwt, Wwt, Mm, Mm, Mm, Wwt, Wot, Wot, Wot, Wwt, Wwt, Wwt, Wot, Wwt, Wwt, Wwt, Wot, Wot, Wwt, Wot, Wwt, Wwt, Wot, Wwt, Wwt, Wwt, Wot, Wwt, Wwt, Wwt, Wwt, Wot, Wot, Wwt
_off^_usr, _off^_usr, _off^_usr, _off^_usr, _off^_usr, _off^_usr, _off^_usr, _off^_usr, _off^_usr, _off^_usr, _off^_usr, _off^_usr, _off^_usr, _off^_usr, _off^_usr, _off^_usr, _off^_usr, _off^_usr, Wot, Wot, Wwt, Wwt, Wot, Wot, Wwt, Wwt, Wwr, Mm, Mm, Mm, Mm, Mm, Wwr, Wot, Wwg^Zro, Wwt, Wwt, Wwt, Wwt, Wwt, Wwt, Wwt, Wwt, Wwt, Wwt, Wot, Wwt, Wwt, Wwt, Wwt, Wot, Wwt, Wot, Wwt, Wwr, Wwr, Wwr, Wwt, Wwt, Wwt
_off^_usr, _off^_usr, _off^_usr, _off^_usr, _off^_usr, _off^_usr, _off^_usr, _off^_usr, _off^_usr, _off^_usr, _off^_usr, _off^_usr, _off^_usr, _off^_usr, _off^_usr, _off^_usr, _off^_usr, _off^_usr, Wot, Wot, Wwt, Wot, Wwg^Zro, Wwr, Wwr, Wwt, Wot, Mm, Mm, Mm, Mm, Mm, Wwt, Wwt, Wwr, Wwrt, Wot, Wwt, Wwt, Wot, Wwt, Wot, Wwt, Wwt, Wot, Wot, Wwt, Wwt, Wwt, Wwt, Wwt, Wwt, Wwt, Wwr, Wot, Wwt, Wwt, Wwr, Wot, Wwr
_off^_usr, _off^_usr, _off^_usr, _off^_usr, _off^_usr, _off^_usr, _off^_usr, _off^_usr, _off^_usr, _off^_usr, _off^_usr, _off^_usr, _off^_usr, _off^_usr, _off^_usr, _off^_usr, _off^_usr, _off^_usr, Wwt, Wwt, Wot, Wot, Wwt, Wwt, Wot, Wot, Wwt, Mm, Ww^Vm, Mm, Wwt, Wwt, Wwt, Wwr, Wwr, Wwt, Wwt, Wwt, Wot, Wot, Wwt, Wwt, Wwt, Wwt, Wot, Wwt, Wwt, Wwt, Wwt, Wot, Wot, Wwr, Wot, Wot, Wwt, Wot, Wwr, Wwt, Wwr, Wwr
_off^_usr, _off^_usr, _off^_usr, _off^_usr, _off^_usr, _off^_usr, _off^_usr, _off^_usr, _off^_usr, _off^_usr, _off^_usr, _off^_usr, _off^_usr, _off^_usr, _off^_usr, _off^_usr, _off^_usr, _off^_usr, Wwt, Wot, Wwt, Wwt, Wwt, Wwt, Wwr, Wwt, Wot, Wwt, Wwt, Wot, Wwt, Wwt, Wwt, Wot, Wwt, Wwt, Wot, Wwt, Wwt, Wwt, Wwt, Wot, Wwt, Wwt, Wwt, Wwt, Wwt, Wwt, Wot, Wwr, Wwt, Wot, Wot, Wwt, Wwr, Wwt, Wwt, Wot, Wot, Wwr
_off^_usr, _off^_usr, _off^_usr, _off^_usr, _off^_usr, _off^_usr, _off^_usr, _off^_usr, _off^_usr, _off^_usr, _off^_usr, _off^_usr, _off^_usr, _off^_usr, _off^_usr, _off^_usr, _off^_usr, _off^_usr, Wot, Wwt, Wot, Wwt, Wot, Wot, Wwt, Wwt, Wot, Wwt, Wwg^Zro, Wwt, Wwr, Wot, Wwt, Wot, Wot, Wot, Wwt, Wwt, Wwt, Wwt, Wwt, Wwt, Wwt, Wwt, Wwt, Wot, Wwt, Wwt, Wwr, Wwt, Wwt, Wwr, Wwr, Wwr, Wot, Wwt, Wwr, Wwr, Wot, Wwr
_off^_usr, _off^_usr, _off^_usr, _off^_usr, _off^_usr, _off^_usr, _off^_usr, _off^_usr, _off^_usr, _off^_usr, _off^_usr, _off^_usr, _off^_usr, _off^_usr, _off^_usr, _off^_usr, _off^_usr, _off^_usr, Wwt, Wwt, Wot, Wwt, Wwt, Wwt, Wot, Wot, Wot, Wwt, Wwt, Wot, Wot, Wot, Wwt, Wwt, Wwt, Wwt, Wot, Wwt, Wwt, Wot, Wot, Wwt, Wot, Wwt, Wwt, Wwt, Wwt, Wwr, Wwr, Wwt, Wwr, Wot, Wot, Wwr, Wwt, Wwt, Wot, Wot, Wot, Wwr
_off^_usr, _off^_usr, _off^_usr, _off^_usr, _off^_usr, _off^_usr, _off^_usr, _off^_usr, _off^_usr, _off^_usr, _off^_usr, _off^_usr, _off^_usr, _off^_usr, _off^_usr, _off^_usr, _off^_usr, _off^_usr, Wwt, Wot, Wwt, Wwt, Wot, Wot, Wwt, Wwt, Wot, Wwt, Wot, Wwt, Wwt, Wwt, Wwt, Wwt, Wwt, Wwt, Wwt, Wwt, Wwt, Wot, Wot, Wot, Wwt, Wot, Wot, Wwt, Wwt, Wwt, Wot, Wwt, Wwr, Wot, Wwr, Wwt, Wwr, Wwr, Wwr, Wwr, Wwr, Wot
_off^_usr, _off^_usr, _off^_usr, _off^_usr, _off^_usr, _off^_usr, _off^_usr, _off^_usr, _off^_usr, _off^_usr, _off^_usr, _off^_usr, _off^_usr, _off^_usr, _off^_usr, _off^_usr, _off^_usr, _off^_usr, Wwt, Wot, Wot, Wwt, Wwt, Wwt, Wot, Wot, Wwt, Wwt, Wwt, Wwt, Wwt, Wwt, Wot, Wwt, Wwt, Wwt, Wwt, Wwt, Wwt, Wwt, Wwt, Wwt, Wwt, Wwt, Wwt, Wwt, Wwt, Wwr, Wot, Wwt, Wwt, Wwt, Wot, Wwt, Wwt, Wwr, Wot, Wot, Wot, Wot
_off^_usr, _off^_usr, _off^_usr, _off^_usr, _off^_usr, _off^_usr, _off^_usr, _off^_usr, _off^_usr, _off^_usr, _off^_usr, _off^_usr, _off^_usr, _off^_usr, _off^_usr, _off^_usr, _off^_usr, _off^_usr, Wot, Wot, Wwt, Wot, Wot, Wwt, Wot, Wwt, Wwt, Wwt, Wwt, Wwt, Wwt, Wwt, Wwt, Wot, Wwt, Wwt, Wwt, Wot, Wot, Wwt, Wwt, Wwt, Wot, Wwt, Wot, Wwt, Wwt, Wwr, Wwt, Wwr, Wwt, Wwt, Wwt, Wwt, Wwr, Wot, Wwr, Wwt, Wwr, Wot
_off^_usr, _off^_usr, _off^_usr, _off^_usr, _off^_usr, _off^_usr, _off^_usr, _off^_usr, _off^_usr, _off^_usr, _off^_usr, _off^_usr, _off^_usr, _off^_usr, _off^_usr, _off^_usr, _off^_usr, _off^_usr, Wot, Wwt, Wwt, Wwt, Wwt, Wot, Wwt, Wwt, Wot, Wot, Wwt, Wot, Wot, Wwt, Wot, Wwt, Wwt, Wot, Wot, Wot, Wwt, Wwt, Wwt, Wwt, Wwt, Wwt, Wwt, Wwt, Wot, Wwt, Wot, Wot, Wwt, Wwr, Wot, Wwr, Wot, Wot, Wot, Wot, Wwr, Wwr
_off^_usr, _off^_usr, _off^_usr, _off^_usr, _off^_usr, _off^_usr, _off^_usr, _off^_usr, _off^_usr, _off^_usr, _off^_usr, _off^_usr, _off^_usr, _off^_usr, _off^_usr, _off^_usr, _off^_usr, _off^_usr, Wot, Wwt, Wwt, Wwt, Wot, Wot, Wot, Wwt, Wot, Wot, Wot, Wwt, Wwt, Wot, Wot, Wot, Wwt, Wwt, Wwt, Wwt, Wot, Wwt, Wwt, Wwt, Wot, Wwt, Wwt, Wot, Wwt, Wwt, Wwt, Wwr, Wwt, Wwr, Wot, Wot, Wwr, Wot, Wwt, Wot, Wot, Wot
_off^_usr, _off^_usr, _off^_usr, _off^_usr, _off^_usr, _off^_usr, _off^_usr, _off^_usr, _off^_usr, _off^_usr, _off^_usr, _off^_usr, _off^_usr, _off^_usr, _off^_usr, _off^_usr, _off^_usr, _off^_usr, Wot, Wwt, Wot, Wot, Wwt, Wwt, Wot, Wot, Wot, Wot, Wwt, Wot, Wwt, Wwt, Wwt, Wwt, Wwt, Wwt, Wwt, Wwt, Wwt, Wwt, Wwt, Wot, Wwt, Wot, Wot, Wwt, Wot, Wwt, Wot, Wot, Wwt, Wwt, Wot, Wot, Wot, Wwt, Wot, Wwr, Wwt, Wot
_off^_usr, _off^_usr, _off^_usr, _off^_usr, _off^_usr, _off^_usr, _off^_usr, _off^_usr, _off^_usr, _off^_usr, _off^_usr, _off^_usr, _off^_usr, _off^_usr, _off^_usr, _off^_usr, _off^_usr, _off^_usr, Wot, Wot, Wwt, Wot, Wwt, Wwt, Wwt, Wwt, Wot, Wot, Wot, Wot, Wwt, Wwt, Wwt, Wwt, Wwt^Bw\, Wwt, Wwt^Bw/, Wwt, Wwt, Wwt, Wwt, Wwt, Wwt, Wwt, Wwt, Wwt, Wot, Wwt, Wot, Wwt, Wwt, Wwt, Wot, Wot, Wwt, Wwt, Wot, Wwr, Wot, Wot
_off^_usr, _off^_usr, _off^_usr, _off^_usr, _off^_usr, _off^_usr, _off^_usr, _off^_usr, _off^_usr, _off^_usr, _off^_usr, _off^_usr, _off^_usr, _off^_usr, _off^_usr, _off^_usr, _off^_usr, _off^_usr, Wot, Wwt, Wot, Wwt, Wot, Wot, Wwt, Wot, Wot, Wot, Wwt, Wwt, Wwt, Wwt^Bw\, Rb, Wwf, Rb, Rb, Wwf, Wwt, Rb, Wwt^Bw/, Wot, Wwt, Wwt, Wwt, Wwt, Wot, Wwt, Wot, Wot, Wwt, Wwt, Wot, Wwt, Wwt, Wwt, Wot, Wot, Wot, Wwt, Wot
_off^_usr, _off^_usr, _off^_usr, _off^_usr, _off^_usr, _off^_usr, _off^_usr, _off^_usr, _off^_usr, _off^_usr, _off^_usr, _off^_usr, _off^_usr, _off^_usr, _off^_usr, _off^_usr, _off^_usr, _off^_usr, Wot, Wot, Wot, Wwt, Wot, Wwt, Wwt, Wot, Wot, Wwt, Wwt, Wwt, Wwf^Vm, Rb, Re^Vct, Rb, Re^Vct, Rb, Rb, Wwf^Vm, Rb, Wot, Wo^Zlh, Wwt, Wot, Wot, Wwt, Wot, Wwt, Wwt, Wwt, Wot, Wot, Wwt, Wwt, Wwt, Wot, Wot, Wot, Wwt, Wot, Wot
_off^_usr, _off^_usr, _off^_usr, _off^_usr, _off^_usr, _off^_usr, _off^_usr, _off^_usr, _off^_usr, _off^_usr, _off^_usr, _off^_usr, _off^_usr, _off^_usr, _off^_usr, _off^_usr, _off^_usr, _off^_usr, Wot, Wot, Wwt, Wwt, Wot, Wwt, Wot, Wwt, Wot, Wot, Wo^Zlh, Wwf, Md, Rb, Rb, Rb, Rb, Re^Vct, Rb, Rb, Re^Vct, Rb, Ds, Wwt, Wot, Wot, Wot, Wwt, Wot, Wot, Wot, Wot, Wot, Wot, Wwt, Wot, Wot, Wwt, Wot, Wwt, Wot, Wot
_off^_usr, _off^_usr, _off^_usr, _off^_usr, _off^_usr, _off^_usr, _off^_usr, _off^_usr, _off^_usr, _off^_usr, _off^_usr, _off^_usr, _off^_usr, _off^_usr, _off^_usr, _off^_usr, _off^_usr, _off^_usr, Wot, Wot, Wot, Wot, Wwt, Wwt, Wwt, Wot, Wot, Ds, Md, Md, Rb, Rb, Md, Md, Re^Vct, Rb, Re^Vct, Re^Ecf, Md, Md, Ds, Wwt, Wot, Wwt, Wot, Wot, Wot, Wwt, Wot, Wwt, Wot, Wwt, Wwt, Wot, Wot, Wwt, Wwt, Wot, Wot, Wot
_off^_usr, _off^_usr, _off^_usr, _off^_usr, _off^_usr, _off^_usr, _off^_usr, _off^_usr, _off^_usr, _off^_usr, _off^_usr, _off^_usr, _off^_usr, _off^_usr, _off^_usr, _off^_usr, _off^_usr, _off^_usr, Ww, Wot, Wot, Wwt, Wwt, Wwt, Wot, Wot, Wot, Ds, Rb, Rb, Md, Md, Md, Md, Md, Md, Md, Md, Gs, Md, Md, Wot, Wwt, Wwt, Wot, Wot, Wwt, Wwt, Wot, Wot, Wwt, Wwt, Wwt, Wot, Wwt, Wwt, Wwt, Wwt, Wot, Wot
