Wot, Wot, Wot, Wot, Wot, Wot, Wot, Wot, Wot, Wot, Wot, Wot, Wot, Wot, Wot, Wot, Wot, Wot, Wot, Wwt, Wwt, Wot, Wwt, Wwt, Wot, Wot, Wot, Wwt, Wwt, Wwt
Wot, Wot, Wot, Wot, Wot, Wot, Wot, Wot, Wot, Wot, Wot, Wot, Wot, Wot, Wot, Wot, Wot, Wot, Wot, Wot, Wot, Wwt, Wot, Wot, Wot, Wot, Wot, Wwt, Wwrt, Wwt
Wot, Wot, Wot, Wot, Wot, Wot, Wot, Wot, Wot, Wot, Wot, Wot, Wot, Wot, Wot, Wot, Wot, Wot, Wot, Wot, Wot, Wwt, Wot, Wot, Wwt, Wot, Wot, Wot, Wot, Wwt
Wot, Wot, Wot, Wot, Wot, Wot, Wot, Wot, Wot, Wot, Wot, Wot, Wot, Wot, Wot, Wot, Wot, Wot, Wot, Wwrt, Wot, Wot, Wot, Wot, Wot, Wwt, Wwt, Wot, Wot, Wot
Wot, Wot, Wot, Wot, Wot, Wot, Wot, Wot, Wot, Wwrt, Wot, Wot, Wot, Wot, Wot, Wot, Wot, Wot, Wot, Wot, Wot, Wot, Wot, Wot, Wot, Wwt, Wwrt, Wwt, Wot, Wot
Wot, Wot, Wot, Wot, Wot, Wot, Wot, Wot, Wwrt, Wwt, Wwt, Wwrt, Wwt, Wot, Ww^Zpoo, Ww^Zpoo, Ww^Zpoo, Wot, Wot, Wot, Wwrt, Wot, Wwt, Wwt, Wot, Wot, Wwt, Wot, Wwt, Wot
Wot, Wot, Wot, Wot, Wwrt, Wot, Wot, Wot, Wwt, Wwt, Wot, Wot, Ww^Zdek, Ww^Zdek, Ww^Zdek, Ww^Zpoo, Ww^Zpoo, Ww^Zpoo, Wot, Wot, Wot, Wot, Wot, Wot, Wwt, Wwt, Wot, Wot, Wot, Wwt
Wot, Wot, Wot, Wwt, Wot, Wot, Wwt, Wwt, Wwt, Wwt, Ww^Zdek, Ww^Zdek, Ww^Zdek, Ww^Zdek, Ww^Zdek, Ww^Zdek, Wot, Wot, Wot, Wot, Wwt, Wwt, Wwrt, Wwt, Wwt, Wwt, Wwrt, Wwt, Wwt, Wot
Wot, Wot, Wot, Wot, Wot, Wot, Wot, Wot, Ww^Zfoc, Ww^Zdek, Ww^Zdek, Ww^Zdek, Ww^Zdek, Ww^Zdek, Wot^Zpie, Wwt, Wwt, Wwt, Wwrt, Wwt, Wot, Wot, Ww^Vm, Wwt, Wwrt, Wwt, Wwt, Wwt, Wwt, Wwrt
Wot, Wot, Wot, Wot, Wot, Wot, Wot, Ww^Zfoc, Ww^Zfoc, Ww^Zfoc, Ww^Zfoc, Ww^Zdek, Wwt, Wwt, Wwt, Wwt, Wwt, Wwt, Wwf, Wwf, Wwt, Wwrt, Wwf, Wwt, Wot, Wwt, Wot, Wwrt, Ds, Wwt
Wot, Wot, Wot, Wot, Wot, Wot^Zrig, Wot^Zral, 3 Ww^Zfoc, Wot^Zhul, Ww^Zfoc, Wot, Wot, Wwrt, Wwt, Wwt, Wot, Wwt, Wwrt, Wot, Wwf, Wwrt, Wwt, Wwrt, Wwt, Wwf^Vhs, Wwt, Wwt, Ds, Wot, Wwt
Wot, Wot, Wot, Wot, Wot, Wot, Wot, Wot, Wot, Wot, Wwt, Wot, Wwt, Wwt, Wwf, Wwt, Wwt, Wwt, Wwt, Wwt, Wwt, Wwt, Ds, Wwf, Wwf, Ds, Wwrt, Wot, Wwt, Wwt
Wot, Wot, Wot, Wot, Wot, Wot, Wot, Wot, Wot, Wot, Wwt, Wwt, Wot, Wwt, Wwf, Wwf, Wwrt, Wwt, Wwf, Wot, Wwrt, Wwt, Wwt, Ds, Ds^Bw|, Ds, Wwt, Wwt, Ds, Ds
Wwt, Wot, Wot, Wot, Wwrt, Wot, Wwt, Wot, Wot, Wwrt, Wwt, Wwt, Wwt, Wwrt, Wwt, Wwrt, Wwt, Wwf, Wwt, Wwt, Wot^Bw/, Wwt, Wwt, Wwt, Wwt^Bw\, Wwt, Ds, Ds^Zbl, Xos, Gg
Wwt, Wwt, Wot, Wot, Wot, Wot, Wot, Wot, Wot, Wwt, Wwrt, Wot, Wwt, Ww^Vm, Wwrt, Wwt, Wwrt, Wwt, Wwrt, Wwt, Wwf^Vhs, Wwt^Bw\, Wwt^Bw/, Wwt, Wwt, Ds^Bw\, 2 Rrc, Rrc, Rrc^Vud, Xos
Wwt, Wwt, Wot, Wot, Wwt, Wot, Wot, Wwt, Wot, Wot, Wwt, Wwt, Wwrt, Wot, Wwt, Wot, Wwt, Wwf, Wwf, Wot, Wwt, Wwrt, Wwt, Wot^Bw\, Wwf^Bw\, Ds, Rrc, Rrc, Rrc, Xos
Wot, Wot, Wot, Wot, Wot, Wwrt, Wot, Wwt, Wwt, Wwt, Wot, Wwt, Wwt, Wwt, Wot, Wwt, Wot, Wwt, Wwt, Wwf, Ds, Wot, Wwt, Wot, Ds, 1 Rrc, Rrc, Rrc, Rrc, Rrc
Wot, Wot, Wot, Wot, Wot, Wwrt, Wwt, Wot, Wwt, Wwt, Wwt, Wwt, Wot, Wwrt, Wwt, Wwt, Wwt, Wot, Wwt, Wwf, Ds, Ds, Wwt, Wot, Wwt, Ds^Zbl, Xos, Rrc^Vud, Xos, Rrc
Wot, Wot, Wot, Wot, Wot, Wot, Wot, Wot, Wot, Wot, Wot, Wwrt, Wot, Wot, Wwrt, Wwt, Wwt, Wwt, Wot, Wot, Wwt, Wwrt, Wot, Wwt, Wwt, Ds, Ds, Xos, Gg, Xos
Wot^Vydo, Wot^Vydh, Wot^Vydo, Wot^Vydh, Wot^Vydo, Wot^Vydh, Wot^Vydo, Wot^Vydh, Wot^Vydo, Wot^Vydh, Wot^Vydo, Wot^Vydh, Wot^Vydo, Wot^Vydh, Wot^Vydo, Wot^Vydh, Wot^Vydo, Wot^Vydh, Wot^Vydo, Wot^Vydh, Wot^Vydo, Wot^Vydh, Wot^Vydo, Wot^Vydh, Wot^Vydo, Wot^Vydh, Wwt^Vydo, Ds^Vydh, Wot^Vydo, Gg^Vydh
Vyd, Vyd, Vyd, Vyd, Vyd, Vyd, Vyd, Vyd, Vyd, Vyd, Vyd, Vyd, Vyd, Vyd, Vyd, Vyd, Vyd, Vyd, Vyd, Vyd, Vyd, Vyd, Vyd, Vyd, Vyd, Vyd, Vyd, Vyd, Vyd, Vyd
Vyd, Vyd, Vyd, Vyd, Vyd, Vyd, Vyd, Vyd, Vyd, Vyd, Vyd, Vyd, Vyd, Vyd, Vyd, Vyd, Vyd, Vyd, Vyd, Vyd, Vyd, Vyd, Vyd, Vyd, Vyd, Vyd, Vyd, Vyd, Vyd, Vyd
Vyd, Vyd, Vyd, Vyd, Vyd, Vyd, Vyd, Vyd, Vyd, Vyd, Vyd, Vyd, Vyd, Vyd, Zld, Vyd, Vyd, Vyd, Vyd, Vyd, Vyd, Vyd, Vyd, Vyd, Vyd, Vyd, Vyd, Vyd, Vyd, Vyd
Vyd, Vyd, Vyd, Vyd, Vyd, Vyd, Vyd, Vyd, Vyd, Vyd, Vyd, Vyd, Zld, Zld, Zld, Zld, Zld, Vyd, Vyd, Vyd, Vyd, Vyd, Vyd, Vyd, Vyd, Vyd, Vyd, Vyd, Vyd, Vyd
Vyd, Vyd, Vyd, Vyd, Vyd, Vyd, Vyd, Vyd, Vyd, Vyd, Zld, Zld, Zld, Zld, Zld, Zld, Vyd, Vyd, Vyd, Vyd, Vyd, Vyd, Vyd, Vyd, Vyd, Vyd, Vyd, Vyd, Vyd, Vyd
Vyd, Vyd, Vyd, Vyd, Vyd, Vyd, Vyd, Vyd, Zld, Zld, Zld, Zld, Zld, Zld, Vyd, Vyd, Vyd, Vyd, Vyd, Vyd, Vyd, Vyd, Vyd, Vyd, Vyd, Vyd, Vyd, Vyd, Vyd, Vyd
Vyd, Vyd, Vyd, Vyd, Vyd, Vyd, Vyd, Vyd, Zld, Zld, Zld, Zld, Zlde, Vyd, Vyd, Vyd, Vyd, Vyd, Vyd, Vyd, Vyd, Vyd, Vyd, Vyd, Vyd, Vyd, Vyd, Vyd, Vyd, Vyd
Vyd, Vyd, Vyd, Vyd, Vyd, Vyd, Vyd, Vyd, Vyd, Vyd, Vyd, Vyd, Vyd, Vyd, Vyd, Vyd, Vyd, Vyd, Vyd, Vyd, Vyd, Vyd, Vyd, Vyd, Vyd, Vyd, Vyd, Vyd, Vyd, Vyd
Vyd, Vyd, Vyd, Vyd, Vyd, Vyd, Vyd, Vyd, Vyd, Vyd, Vyd, Vyd, Vyd, Vyd, Vyd, Vyd, Vyd, Vyd, Vyd, Vyd, Vyd, Vyd, Vyd, Vyd, Vyd, Vyd, Vyd, Vyd, Vyd, Vyd
