Xu, Xu, Xu, Zs, Zs, Xu, Xu, Xu, Xu, Xu, Uu^Uf, Uh, Uh, Xos, Xos, Zs, Zs, Xol, Xol, Chr, Urb, Urb, Urb, Chr, Xol, Xol, Zs, Zs, Xos, Xos, Uu^Uf, Uu^Uf, Uh, Xu, Xu, Xu, Xu, Xu, Xu, Xu, Xu, Xu, Xu, Xu
Xu, Xu, Xu, Xu, Xu, Zs, Xu, Xu, Uh, Uh, Xu, Uu^Uf, Zs^Uf, Uh, Xos, Xos, Zs, Urb^Vud, Urb, Xol, Urb^Pr\o, Urb, Urb^Pr/o, Xol, Urb, Urb^Vud, Zs, Xos, Xol, Uh, Uh, Uu^Uf, Zsf, Uh, Uh, Xu, Xu, Xu, Xu, Xu, Xu, Xu, Xu, Xu
Xu, Xu, Xu, Xu, Xu, Zs, Zs, Xu, Uh^Uf, Xu, Xu, Xu, Zs^Uf, Xos, Xos, Xos, Zs, Xol, Xol, Urb, Urb, Xol, Urb, Urb, Xol, Xol, Zs, Xol, Xos, Xos, Uu^Uf, Zsf, Uh, Uu^Uf, Uh, Uu^Uf, Xu, Xu, Xu, Xu, Zs, Xu, Zs, Xu
Xu, Xu, Xu, Xu, Xu, Xu, Xu, Zs, Zs, Xu, Zs^Uf, Xu, Chs, Xos, Chs, Xos, Zs, Chs, Uu^Vud, Xol, Urb, Chr, Urb, Xol, Uu^Vud, Chr, Zs, Xos, Chs^Uf, Xos, Chs, Uh^Uf, Zs, Uu^Uf, Zs, Uh, Zs, Zs^Uf, Zs, Zs, Zs, Zs, Xu, Zs
Xu, Xu, Xu, Xu, Xu, Xu, Uh, Uh^Uf, Uh, Zs, Uh, Zs, Zs, Rb, Zs, Rb, Cud, Xol, Urb, Urb, Chr, Uu^Vud, Chr, Urb, Urb, Xol, Chs, Zs, Zs, Rb, Zs, Zs, Uu^Uf, Zs, Uu^Vu, Zs, Uu^Uf, Xu, Xu, Xu, Cud^Uf, Xu, Xu, Xu
Xu, Xu, Xu, Xu, Xu, Xu, Uh^Uf, Uu^Vud, Xu, Cud, Uh, Zs^Bw\, Uh, Xu, Cud^Ebn, Xol, Urb, Urb, Urb, Chr, Uu^Vud, 4 Kud, Uu^Vud, Chr, Urb, Urb, Zsf, Xol, Ch, Xu, Uu^Uf, Uh, Xu, Uh, Zsf, Uh, Re, Uh, Zsf, Xu, Cud, Xu, Xu, Xu
Xu, Xu, Xu, Xu, Xu, Xu, Zs, Cud, Cud^Ebn, Cud, Zs, Zs^Uf, Zs, Uh^Uf, Xu, Re^Uf, Urb, Xol, Chr, Chr, Chr, Cud^Ebn, Chr, Chr, Chr, Xol, Zsf, Ch, Ch^Ebn, Xu, Zsf, Xu, Xu, Uue, Xu, Zsf, Uu^Uf, Zsf, Re, Cud^Ebn, Cud, Xu, Xu, Xu
Xu, Xu, Xu, Xu, Xu, Zs^Uf, Zs^Uf, Zs, Zs, Zs, Zs, Zs, Zs, Xu, Xu, Xu, Xu, Urb, Urb, Xol, Urb, Chr, Urb, Xol, Urb, Urb, Chs, Ch, Uh^Uf, Uh^Uf, Re, Xu, Xu, Xu, Xu, Ur, Xu, Ur, Ur, Cud, Xu, Xu, Xu, Xu
Xu, Xu, Xu, Xu, Xu, Xu, Zs^Uf, Zs, Uh, Zs^Uf, Xu, Uh^Uf, Uh^Uf, Zs, Zs, Xu, Re^Uf, Cud^Ebn, Cud, Urb, Urb, Xol, Urb, Urb, Uu^Vud, Ch^Ebn, Ss^Bw\, Zs, Xu, Ur, Ur, Ur, Zsf, Re, Ur, Xu, Zsf, Re, Xu, Xu, Xu, Xu, Xu, Xu
Xu, Xu, Xu, Xu, Xu, Xu, Uh, Zs^Bw/, Xu, Xu, Xu, Uh^Uf, Xu, Uh, Uu^Vud, Zs, Zs^Bw/, Re, Re, Cud, Cud^Ebn, Uu^Vud, Xu, Xu, Xu, Ur, Re, Uh, Ur, Sm, Uu, Uu^Vu, Uu, Xu, Xu, Re, Re, Zsf^Uf, Xu, Xu, Xu, Xu, Xu, Xu
Xu, Xu, Xu, Xu, Zsf, Zsf, Uh, Zs, Zs, Uu^Vu, Zsf, Xu, Uh, Zsf, Zsf, Uh, Uh, Zs, Zs, Re^Uf, Re^Uf, Xu, Xu, Uue, Xu, Xu, Zs, Uh, Uh^Uf, Re, Xu, Uu, Ur, Uu^Uf, Xu, Xu, Uh, Zsf, Zsf, Zsf, Xu, Xu, Xu, Xu
Xu, Xu, Xu, Re, Xu, Xu, Zs^Uf, Xu, Rb, Xu, Zsf, Xu, Zsf, Re, Xu, Xu, Xu, Re, Xu, Zs, Xu, Sm, Sm^Uf, Uue, Uh, Zs, Xu, Zs, Zs, Xu, Uu, Ur, Cud^Ebn, Ur, Uu, Xu, Xu, Uh, Xu, Uu, Zsf, Xu, Xu, Xu
Xu, Xu, Re, Zsf, Uu, Uh, Zs, Xu, Sm, Xu, Ur, Uh, Ur^Uf, Zsf, Ur, Zsf, Zsf, Uh, Zs, Zs, Re, Ur, Ur, Sm, Xu, Zs, Zs^Uf, Xu, Zs, Uu, Re, Ur, Kud, Ur, Ur, Uu^Uf, Xu, Uh, Xu, Xu, Zsf, Xu, Xu, Xu
Xu, Xu, Xu, Uh, Xu, Zs^Uf, Rb, Xu, Uh, Uh, Uu, Re, Re, Re, Cud, Cud^Ebn, Cud, Uh, Zs, Uh^Uf, Xu, Re^Uf, Re, Ur, Uu^Uf, Zs, Cud, Zs, Cud, Zs, Zs, Cud, Uu^Uf, Cud, Ur, Uu, Xu, Uu^Uf, Xu, Uue, Uh, Re, Xu, Xu
Xu, Xu, Xu, Uh, Xu, Rb, Sm, Uh, Xu, Uh, Uu^Uf, Zsf, Re, Zs, Zs, Zs, Zs, Kud, Zs, Xu, Xu, Uue, Xu, Xu, Zs, Zs, Uu^Uf, Cud^Ebn, Uh, Xu, Zs, Re, Re, Ur, Ur, Uu, Uu, Uh, Xu, Xu, Ur, Xu, Xu, Xu
Xu, Xu, Xu, Re, Re, Xu, Re, Uu^Uf, Xu, Xu, Xu, Uu^Uf, Re, Zs, Xu, Xu, Zs, Zs, Uh, Uue, Uue, Xu, Uue, Xu, Uh, Zs, Xu, Re^Uf, Zs, Zs, Xu, Zs^Bw|, Zs, Xu, Xu, Uu^Vu, Uh, Uu, Ur, Uu, Ur, Xu, Xu, Xu
Xu, Xu, Xu, Uu^Uf, Uu, Xu, Re, Cud, Uu, Zsf, Zsf, Re, Uh, Zs, Zs, Zs^Uf, Uh, Xu, Sm, Xu, Xu, Xu, Re, Uu^Uf, Uu, Xu, Uh, Zs, Uh, Uh, Zsf, Uh, Zs, Zs, Uh, Xu, Xu, Xu, Uu, Uu, Xu, Xu, Xu, Xu
Xu, Xu, Xu, Uu^Vud, Ur, Xu, Re, Cud^Ebn, Cud, Xu, Xu, Uh^Uf, Zs, Zs^Bw\, Uu, Uh, Zsf, Re, Re, Uh, Uu^Vu, Uu^Uf, Zs, Xu, Xu, Re, Zs^Bw\, Zs, Xu, Cud, Cud^Ebn, Cud, Zs, Xu, Ur, Uu^Uf, Uu^Uf, Re, Ur, Uu^Vud, Xu, Xu, Xu, Xu
Xu, Xu, Xu, Xu, Xu, Ur, Ur, Ur, Re, Re, Xu, Uu^Vu, Zs, Uh^Uf, Cud, Re, Cud, Re, Zs, Zs, Zs, Zs, Xu, Zs, Zs, Zs, Re^Uf, Sm, Uu, Xu, Uu, Uh, Zs, Xu, Re, Re, Cud^Ebn, Uu, Uu, Uu, Uh, Xu, Xu, Xu
Xu, Xu, Xu, Xu, Xu, Xu, Uh, Re, Zs, Uu^Uf, Uu^Uf, Zs, Uh, Uh^Uf, Uu, Cud^Ebn, Re, Uh, Zs^Bw\, Xu, Xu, Re, Uu^Uf, Uh, Xu, Re^Uf, Xu, Xu, Uu, Uh, Xu, Uh, Zs, Zs, Uh, Cud, Ur, Cud, Uu, Uu^Uf, Uu, Xu, Xu, Xu
Xu, Xu, Xu, Xu, Xu, Xu, Re, Zs, Re, Zs, Re, Uh, Xu, Xu, Xu, Re, Zs, Zs, Uh, Uh, Ur, Ur, Uh, Uu, Ur, Uu^Vu, Uu, Uu^Uf, Uh, Xu, Ur, Uu^Uf, Re, Zs^Bw/, Zs, Re, Ur, Ur, Xu, Uh, Uu, Xu, Xu, Xu
Xu, Xu, Xu, Xu, Xu, Re, Ur^Uf, Re, Xu, Re, Sm, Ur, Uh, Xu, Uu^Uf, Uu, Re, Xu, Xu, Sm, Uu^Vu, Xu, Uh, Xu, Xu, Uu, Xu, Uh, Xu, Uu^Uf, Uu^Vu, Xu, Xu, Zs, Xu, Xu, Ur, Re, Sm, Xu, Uu, Xu, Xu, Xu
Xu, Xu, Xu, Xu, Xu, Ur, Re, Xu, Xu, Uu, Uh, Xu, Xu, Uu, Xu, Uu, Re, Xu, Zs, Re, Zs, Xu, Uue, Uh, Uu, Uu^Vu, Ur, Uh, Xu, Ur, Re, Sm, Uu, Re, Rb, Xu, Uh, Uu, Ur, Uu^Vu, Uh, Xu, Xu, Xu
Xu, Xu, Xu, Uu^Uf, Zsf, Zsf, Zsf^Uf, Uu, Uu^Uf, Zs, Xu, Xu, Xu, Xu, Xu, Zsf, Uh, Zs, Re, Re, Zs, Xu, Uue, Xu, Uh, Uu^Uf, Uu, Xu, Xu, Ur, Xu, Zsf, Xu, Uu, Rb, Re, Xu, Uu^Uf, Xu, Xu, Xu, Xu, Xu, Xu
Xu, Xu, Xu, Uu^Uf, Re, Xu, Zsf, Re, Re, Uu^Vu, Uh, Xu, Xu, Xu, Uu^Vu, Re, Uu, Re, Re, Zs, Uue, Xu, Xu, Uu, Co, Co, Co, Uh, Xu, Uu^Uf, Zsf, Xu, Xu, Xu, Zs, Zs, Zs, Re, Xu, Xu, Xu, Xu, Xu, Xu
Xu, Xu, Xu, Uh, Xu, Re, Zsf^Uf, Uu, Re, Uu^Uf, Zsf, Xu, Xu, Xu, Xu, Uh, Ur, Re, Zs, Zs, Xu, Uue, Xu, Ur, Uh, Co, Ur, Ur, Xu, Xu, Zsf, Zsf, Zsf, Uu^Vud, Uh, Zs, Zs^Bw/, Uh, Xu, Xu, Xu, Xu, Xu, Xu
Xu, Xu, Xu, Xu, Xu, Uh, Uh, Xu, Ur, Xu, Zsf, Xu, Uu^Uf, Xu, Ur, Uu^Uf, Ur, Re, Re^Vct, Re^Vct, Xu, Uue, Xu, Uu^Vu, Ur, 5 Ko, Ur, Uu^Vu, Xu, Uue, Xu, Cud, Cud, Zsf, Cud, Re^Vct, Zs, Zs^Uf, Zs, Uh, Xu, Zs^Uf, Zs, Zs
Xu, Xu, Xu, Xu, Xu, Xu, Uu^Uf, Uu, Ur, Xu, Uh, Xu, Uu^Vud, Ur, Cud, Re^Vct, Cud, Re^Vct, Cud, Cud, Xu, Uue, Uue, Xu, Xu, Ur, Xu, Xu, Uue, Uue, Ur, Re^Vct, Xu, Cud, Cud, Cud, Cud, Rb, Zs, Xu, Zs, Zs, Zs, Zs
Xu, Xu, Xu, Xu, Xu, Xu, Xu, Uh, Xu, Ur, Ur, Ur, Ur, Ur, Cud, Cud, Xu, Kud, Re^Vct, Cud, Xu, Xu, Uh, Xu, Uu^Vud, Xu, Uu^Vud, Xu, Uu^Uf, Xu, Ur, Xu, Re^Vct, Kud, Re^Vct, Re^Vct, Xu, Xu, Xu, Zs, Zs, Zs^Uf, Xu, Xu
Xu, Xu, Xu, Xu, Xu, Xu, Xu, Xu, Xu, Uu^Uf, Xu, Ur, Xu, Xu, Xu, Xu, Xu, Xu, Xu, Ur, Ur, Xu, Uu^Uf, Cud, Cud, 3 Kud, Cud, Cud, Uu, Uu, Ur, Ur, Xu, Xu, Xu, Xu, Xu, Xu, Xu, Xu, Xu, Zs, Xu, Xu
Xu, Xu, Xu, Xu, Xu, Xu, Xu, Xu, Xu, Xu, Xu, Xu, Xu, Xu, Xu, Xu, Xu, Xu, Xu, Xu, Uh, Ur, Ur, Ur, Uu, Uu^Vud, Ur, Uu, Ur, Ur, Uu, Ur, Xu, Xu, Xu, Xu, Xu, Xu, Xu, Xu, Xu, Xu, Xu, Xu
Xu, Xu, Xu, Xu, Xu, Xu, Xu, Xu, Xu, Xu, Xu, Xu, Xu, Xu, Xu, Xu, Xu, Xu, Xu, Xu, Uh, 1 Ur, Ur, Ur, Ur, Ur, Uu, Ur, Uu, Uh, 2 Ur, Ur, Xu, Xu, Xu, Xu, Xu, Xu, Xu, Xu, Xu, Xu, Xu, Xu
Xu, Xu, Xu, Xu, Xu, Xu, Xu, Xu, Xu, Xu, Xu, Xu, Xu, Xu, Xu, Xu, Xu, Xu, Xu, Xu, Xu, Re^Vct, Re^Vct, Ur, Uu, Cud^Zbo, Xu, Ur, Ur, Ur, Re^Vct, Ur, Xu, Xu, Xu, Xu, Xu, Xu, Xu, Xu, Xu, Xu, Xu, Xu
Xu, Xu, Xu, Xu, Xu, Xu, Xu, Xu, Xu, Xu, Xu, Xu, Xu, Xu, Xu, Xu, Xu, Xu, Xu, Xu, Xu, Uue, Uue, Re^Vct, Uu, Xu, Uu, Ur, Re^Vct, Re^Vct, Uue, Xu, Xu, Xu, Xu, Xu, Xu, Xu, Xu, Xu, Xu, Xu, Xu, Xu
Xu, Xu, Xu, Xu, Xu, Xu, Xu, Xu, Xu, Xu, Xu, Xu, Xu, Xu, Xu, Xu, Xu, Xu, Xu, Xu, Xu, Xu, Xu, Uue, Uu, Uu, Xu, Uu, Uue, Uue, Uue, Xu, Xu, Xu, Xu, Xu, Xu, Xu, Xu, Xu, Xu, Xu, Xu, Xu
Xu, Xu, Xu, Xu, Xu, Xu, Xu, Xu, Xu, Xu, Xu, Xu, Xu, Xu, Xu, Xu, Xu, Xu, Xu, Xu, Xu, Xu, Xu, Xu, Xu, Uu, Uu, Uu, Xu, Xu, Xu, Xu, Xu, Xu, Xu, Xu, Xu, Xu, Xu, Xu, Xu, Xu, Xu, Xu
Xu, Xu, Xu, Xu, Xu, Xu, Xu, Xu, Xu, Xu, Xu, Xu, Xu, Xu, Xu, Xu, Xu, Xu, Xu, Xu, Xu, Xu, Xu, Xu, Xu, Uu, Uu, Uu, Xu, Xu, Xu, Xu, Xu, Xu, Xu, Xu, Xu, Xu, Xu, Xu, Xu, Xu, Xu, Xu
