Xos, Xos, Xos, Xos, Xos, Xos, Xos, Xos, Xos, Xos, Xos, Xos, Xos, Xos, Xos, Xos, Xos, Xos, Xos
Xos, Xos, Xos, Xos, Xos, Xos, Xos, Xos, Xos, Xos, Xos, Xos, Xos, Xos, Xos, Xos, Xos, Xos, Xos
Xos, Xos, Xos, Xos, Rp, Rp^Edb, Rp^Dr, Xos, Xos, Xos, Xos, Xos, Rp^Edb, Rp^Dr, Rp, Xos, Xos, Xos, Xos
Xos, Xos, Xos, Xos, Rp, Rp, Xol, Xol, Ch^Vu, Xos, Ch^Vu, Xol, Xol, Rp, Rp, Xos, Xos, Xos, Xos
Xos, Xos, Xos, Xos, Xol, Rr^Pr/, Rrc, Rrc, Rrc, Rrc, Rrc, Rrc, Rrc, Rr^Pr\, Xol, Xos, Xos, Xos, Xos
Xos, Xos, Xos, Xol, Rrc, Rrc, Rrc, Rrc, Xos, Ch, Xos, Rrc, Rrc, Rrc, Rrc, Xol, Xos, Xos, Xos
Xos, Xos, Xos, Xos, Ch, Rrc, Xos, Xos, Rrc^Vu, Xos, Rrc^Vu, Xos, Xos, Rrc, Ch, Xos, Xos, Xos, Xos
Xos, Xos, Xos, Xos, Xos, Rrc, Xos, Rrc^Vu, Rrc, Rrc, Rrc, Rrc^Vu, Xos, Rrc, Xos, Xos, Xos, Xos, Xos
Xos, Xos, Xos, Xos, Xol, Rrc, Rrc^Vu, Xos, Rrc, Rr, Rrc, Xos, Rrc^Vu, Rrc, Xol, Xos, Xos, Xos, Xos
Xos, Xos, Xos, Xol, Rrc, Rrc, Rrc, Xos, Xos, Rrc, Xos, Xos, Rrc, Rrc, Rrc, Xol, Xos, Xos, Xos
Xos, Xos, Xos, Xos, Ch, Rrc, Xos, Rrc, Rrc, Rrc, Rrc, Rrc, Xos, Rrc, Ch, Xos, Xos, Xos, Xos
Xos, Xos, Xos, Xos, Xos, Rrc, Rrc, Ch, Ch, 4 Kh, Ch, Ch, Rrc, Rrc, Xos, Xos, Xos, Xos, Xos
Xos, Xos, Xos, Xos, Xol, Rrc, Xos, Rrc, Rrc, Ch, Rrc, Rrc, Xos, Rrc, Xol, Xos, Xos, Xos, Xos
Xos, Xos, Xos, Xol, Rrc, Rrc, Rrc, Ch, Rrc, Rrc, Rrc, Ch, Rrc, Rrc, Rrc, Xol, Xos, Xos, Xos
Xos, Xos, Xos, Xos, Ch^Vu, Rrc, Xos, Rrc, Rrc, Rrc^Ebn, Rrc, Rrc, Xos, Rrc, Ch^Vu, Xos, Xos, Xos, Xos
Xos, Xos, Ch^Vu, Xol, Xol, Rrc, Rrc, Ch, Rrc, Rrc, Rrc, Ch, Rrc, Rrc, Xol, Xol, Ch^Vu, Xos, Xos
Xos, Xos, Rrc, Rrc, Xos, Rrc, Xos, Rrc, Rrc, Rrc, Rrc, Rrc, Xos, Rrc, Xos, Rrc, Rrc, Xos, Xos
Xos, Xos, Rrc, Ch, Xos, Rrc, Rrc^Ebn, Ch, Rrc, Rrc^Vu, Rrc, Ch, Rrc^Ebn, Rrc, Xos, Ch, Rrc, Xos, Xos
Xos, Xos, Ch^Vu, Rrc, Rrc, Rrc, Rrc, Rrc, Rrc, Xos, Rrc, Rrc, Rrc, Rrc, Rrc, Rrc, Ch^Vu, Xos, Xos
Xos, Xos, Xos, Xos, Xos, Rrc, Xos, Xos, Xol, Rrc, Xol, Xos, Xos, Rrc, Xos, Xos, Xos, Xos, Xos
Xos, Xos, Xos, Xos, Xos, Rrc, Rrc^Vu, Xol, Rrc, Rrc, Rrc, Xol, Rrc^Vu, Rrc, Xos, Xos, Xos, Xos, Xos
Xos, Xos, Xos, Xos, Xos, Rrc, Rrc, Rrc, 1 Rrc, Rrc, 2 Rrc, Rrc, Rrc, Rrc, Xos, Xos, Xos, Xos, Xos
Xos, Xos, Xos, Xos, Xos, Xos, Xos, Rrc, Rrc, Rrc, Rrc, Rrc, Xos, Xos, Xos, Xos, Xos, Xos, Xos
Xos, Xos, Xos, Xos, Xos, Xos, Xos, Rrc, Rrc, Rrc, Rrc, Rrc, Xos, Xos, Xos, Xos, Xos, Xos, Xos
