Ql, Ql, Ql, Ql, Ql, Ql, Ql, Ql, Ql, Ql, Ql, Ql, Ql, Ql, Ql, Ql, Ql
Ql, Ql, Mv, Ql, Ql, Ql, Qlf, Ql, Qlf, Ql, Qlf, Ql, Ql, Ql, Mv, Ql, Ql
Ql, Ql, Ql, Qlf, Qlf, Qlf, Zfop^Ecf, Qlf, Mv, Qlf, Zfop^Ecf, Qlf, Qlf, Qlf, Ql, Ql, Ql
Ql, Ql, Qlf, Qlf, Zfop, Ur^Edt, Zfop^Dr, Zfop^Edb, Zfop^Dr, Zfop^Edb, Zfop^Edb, Zfop, Zfop^Dr, Qlf, Qlf, Ql, Ql
Ql, Ql, Qlf, Zfop^Ecf, Uh^Fetd, Uh^Fetd, Uh^Fetd, Ur^Edt, Zfop^Edb, Zfop^Edb, Ur^Edb, Uh^Fetd, Uh^Fetd, Zfop^Ecf, Qlf, Ql, Ql
Ql, Ql, Qlf, Zfop^Dr, Uh^Fetd, 1 Zfop, Uh^Fetd, Zfop^Edb, Zfop^Vd, Zfop^Edb, Uh^Fetd, Zfop, Uh^Fetd, Zfop, Qlf, Ql, Ql
Ql, Ql, Qlf, Zfop, Uh^Fetd, Zfop, Zfop^Edt, Zfop^Edb, Zfop^Edb, Zfop^Dr, Uh^Fetd, 2 Zfop, Uh^Fetd, Ur^Edb, Qlf, Ql, Ql
Ql, Ql, Qlf, Zfop^Ecf, Zfop, Uh^Fetd, Zfop^Dr, Zfop^Edb, Zfop, Zfop^Edb, Ur^Edb, Uh^Fetd, Ur^Edb, Zfop^Ecf, Qlf, Ql, Ql
Ql, Ql, Ql, Qlf, Qlf, Ur^Edb, Zfop^Ecf, Zfop, Mv, Zfop^Dr, Zfop^Ecf, Zfop, Qlf, Qlf, Ql, Ql, Ql
Ql, Ql, Mv, Qlf, Ql, Qlf, Qlf, Qlf, Qlf, Qlf, Qlf, Qlf, Ql, Qlf, Mv, Ql, Ql
Ql, Ql, Ql, Ql, Ql, Ql, Ql, Ql, Ql, Ql, Ql, Ql, Ql, Ql, Ql, Ql, Ql
Ql, Ql, Ql, Ql, Ql, Ql, Ql, Ql, Ql, Ql, Ql, Ql, Ql, Ql, Ql, Ql, Ql
