border_size=1
usage=map

Gg^Fet      , Gg^Efm         , Gg^Fet      , Gg^Efm         , Gg^Fet      , Gg^Fet      , Gg^Fet      , Gg^Fet      , Gg^Fet      , Gg^Fet      , Gg^Fet      , Gg^Fet      , Gg^Fet      , Gg^Efm         
Gg^Fet      , Gg^Fet      , Gg^Fet      , Gg^Fet      , Gg^Fet      , Gg^Fet      , Gg^Efm      , Gg^Fet      , Gg^Efm      , Gg^Fet      , Gg^Fet      , Gg^Fet      , Gg^Fet      , Gg^Fet      
Gg^Fet      , Gg^Fet      , Gg^Fet      , Gg^Fet      , Gg^Fet      , Gg^Efm      , Rp          , Gg^Efm      , Rp          , Gg^Efm      , Gg^Fet      , Gg^Fet      , Gg^Fet      , Gg^Fet      
Gg^Fet      , Gg^Fet      , Gg^Fet      , Gg^Fet      , Gg^Efm      , Gg^Efm      , Rp          , Rp          , Rp          , Gg^Efm      , Gg^Efm      , Gg^Fet      , Gg^Fet      , Gg^Fet      
Gg^Fet      , Gg^Fet      , Gg^Efm      , Gg^Efm      , Gg^Efm      , Rp          , Rp          , Rp          , Rp          , Rp          , Gg^Efm      , Gg^Efm      , Gg^Efm      , Gg^Fet      
Gg^Fet      , Gg^Fet      , Gg^Fet      , Gg^Efm      , Gg^Efm      , Gg^Efm      , 1 Rp        , Rp          , 2 Rp        , Gg^Efm      , Gg^Efm      , Gg^Efm      , Gg^Fet      , Gg^Fet      
Gg^Fet      , Gg^Fet      , Gg^Fet      , Gg^Fet      , Gg^Fet      , Gg^Efm      , Gg^Efm      , Gg^Efm      , Gg^Efm      , Gg^Efm      , Gg^Fet      , Gg^Fet      , Gg^Fet      , Gg^Fet      
Gg^Efm         , Gg^Fet      , Gg^Fet      , Gg^Fet      , Gg^Fet      , Gg^Fet      , Gg^Fet      , Gg^Efm      , Gg^Fet      , Gg^Fet      , Gg^Fet      , Gg^Fet      , Gg^Fet      , Gg^Fet      
