border_size=1
usage=map

_off^_usr   , _off^_usr   , _off^_usr   , _off^_usr   , _off^_usr   , _off^_usr   , _off^_usr   , _off^_usr   , _off^_usr   , _off^_usr   , _off^_usr   , _off^_usr   , _off^_usr   
Qxu         , Qxu         , Qxu         , Qxu         , Qxu         , Qxu         , Qxu         , Qxu         , Qxu         , Qxu         , Qxu         , Qxu         , Qxu         
Qxu         , Qxu         , Qxu         , Qxu         , Qxu         , Qxu         , Ch^Vu       , Qxu         , Qxu         , Qxu         , Qxu         , Qxu         , Qxu         
Qxu         , Qxu         , Qxu         , Qxu         , Ch          , Ch          , Qxu         , Ch          , Ch          , Qxu         , Qxu         , Qxu         , Qxu         
Qxu         , Qxu         , Qxu         , Ch          , 1 Ch        , Qxu         , Ch          , Qxu         , Ch          , Ch          , Qxu         , Qxu         , Qxu         
Qxu         , Qxu         , Qxu         , Ch          , Ch          , Qxu         , Qxu         , Qxu         , Ch          , Ch          , Qxu         , Qxu         , Qxu         
Qxu         , Qxu         , Qxu         , Ch          , 2 Ch        , Qxu         , Qxu         , Qxu         , Ch          , Ch          , Qxu         , Qxu         , Qxu         
Qxu         , Qxu         , Qxu         , Ch          , Ch          , Qxu         , Qxu         , Qxu         , Ch          , Ch          , Qxu         , Qxu         , Qxu         
Qxu         , Qxu         , Qxu         , Qxu         , Qxu         , Ch          , Ch^Vu       , Ch          , Qxu         , Qxu         , Qxu         , Qxu         , Qxu         
Qxu         , Qxu         , Qxu         , Qxu         , Qxu         , Qxu         , Qxu         , Qxu         , Qxu         , Qxu         , Qxu         , Qxu         , Qxu         
Qxu         , Qxu         , Qxu         , Qxu         , Qxu         , Qxu         , Qxu         , Qxu         , Qxu         , Qxu         , Qxu         , Qxu         , Qxu         
Qxu         , Qxu         , Qxu         , Qxu         , Qxu         , Qxu         , Qxu         , Qxu         , Qxu         , Qxu         , Qxu         , Qxu         , Qxu         
