Wo, Wo, Wwt, Wwt, Wwt, Wwt, Gg^Efm, Gg^Efm, Ds, Gs^Fdf, Wwf, Gg^Efm, Gg^Efm, Gg^Efm, Wwf, Gs^Fdf, Gg^Efm, Ds, Gg^Efm, Wwt, Wwt, Wo, Wo
Wo, Wwt, Wwt, Wwrg, Wwt, Gg^Efm, Gg^Efm, Gg^Efm, Wwf, Wwf, Wwf, Gg^Efm, Gg^Efm, Ds, Wwf, Wwf, Wwf, Gg^Efm, Wwt, Wwt, Wwrg, Wwt, Wwt
Wo, Wo, Wwt, Wwt, Wwt, Wwt, Wwt, Wwf, Gg^Efm, Gg^Efm, Ds, Wwf, Wwf, Gg^Efm, Gg^Efm, Wwf, Wwt, Wwt, Wwt, Wwrg, Wo, Wwrg, Wwt
Wo, Wo, Wwt, Wwt, Wwrg, Wwt, Wwt, Wwt, Wwt, Wwf, Wwt, Wwf, Wwt, Wwf, Wwt, Wwt, Wwt, Wwt, Wwt, Wo, Wwt, Wwt, Wwt
Wo, Wwt, Wwt, Wwg, Wo, Wwf, Wwt, Wwt, Wwt, Wwt, Wwt, Wwt, Wwg, Wwt, Wwt, Wwt, Wo, Wo, Wwg, Wwt, Wwt, Wwt, Wo
Wo, Wo, Wo, Wwt, Wwt, Wwt, Wo, Wwt, Wo, Wwt, Wo, Wwrg, Wo, Wo, Wwt, Wwt, Wwt, Wo, Wwt, Wwrg, Wwrg, Wo, Wo
Wo, Wo, Wwt, Wwt, Wwrg, Wwt, Wwt, Wwf, Wwt, Wo, Wo, Wo, Wwt, Wwt, Wwt, Wo, Wwg, Wwf, Wwt, Wwrg, Wwt, Wwt, Wwt
Wo, Wo, Wwt, Wwt, Wwt, Wwrg, Wwrg, Wwt, Wwg, Wwt, Wwt, Wwt, Wwrg, Wwrg, Wwt, Wwt, Wo, Wo, Wwrg, Wwt, Wo, Wwt, Wo
Wo, Wo, Wo, Wwt, Wo, Wwt, Wwt, Wwt, Wwt, Wwt, Wo, Wwrg, Wwt, Wwf, Wwt, Wwt, Wwt, Wo, Wwt, Wo, Wo, Wwrg, Wo
Wo, Wo, Wwt, Wwrg, Wo, Wo, Wwt, Wwt, Wwt, Wwt, Wwt, Wo, Wwt, Wwt, Wwt, Wwf, Wwt, Wwt, Wwt, Wo, Wwt, Wwrg, Ww
Ww, Wo, Wwt, Wwrg, Wwf, Wwrg, Wwt, Wwt, Wwt, Wwf, Wo, Wwt, Wog, Wog, Wwt, Wwt, Wwt, Wo, Wwt, Wwg, Wwt, Wwg, Wo
Ww, Wo, Wo, Wwg, Wwt, Wwt, Wwt, 1 Wwt, Wwrg, Wwt, Wwrg, Wwt, Wwt, Wwrg, Wwt, 2 Wwt, Wwt, Wwg, Wwt, Wwt, Wwt, Wo, Wo
Wo, Wo, Wo, Wwt, Wo, Wwrg, Wwt, Wwt, Wwt, Wwt, Wwrg, Wwf, Wwt, Wwt, Wwg, Wwt, Wwt, Wwrg, Wo, Wwt, Wo, Wo, Wo
Wo, Wo, Wo, Wo, Wo, Wo, Wo, Wwt, Wo, Wo, Wo, Wwg, Wo, Wo, Wo, Wo, Wo, Wwt, Wo, Wo, Wo, Wo, Wo
