Ww, Wo, Wo, Wo, Wo, Wo, Wo, Wo, Wo, Wo, Ww, Wo, Wo, Wo, Ww, Ww, Ww, Wo
Ww, Wo, Wo, Wo, Wo^Xo, Wo^Xo, Wo^Xo, Wo, Wo^Xo, Wo, Wo^Xo, Wo, Wo, Wo, Wo, Ww, Ww, Wo
Ww, Wo, Wo^Xo, Wo^Xo, ZWKe, Ww^ZBw|, ZWCe, Wo^Xo, ZWCe, Wo^Xo, ZWCe, Wo^Xo, Wo^Xo, Wo, Wo, Ww, Ww, Wo
Ww, Ww, Wo^Xo, ZWKe, ZWCe, ZWCe, ZWCe, ZWCe, ZWCe, ZWCe, ZWCe, ZWCe, 1 ZWCe, Wo^Xo, Wo^Xo, Wo, Ww, Ww
Ww, Ww, Wo^Xo, ZWKe, ZWCe, ZWCe^Zwk, ZWCe, ZWf^Zwv, ZWCe, ZWf^Zwv, ZWCe, ZWCe, 2 ZWCe, ZWCe, Wo^Xo, Wo, Ww, Wo
Wo, Wo, Wo^Xo, ZWKe, ZWKe, ZWCe, ZWCe, ZWCe, ZWCe, ZWCe, ZWCe, ZWCe, Wo^Xo, Wo^Xo, Wo, Wo, Wo, Wo
Wo, Wo, Wo, Wo^Xo, Wo^Xo, Wo^Xo, Wo^Xo, Wo^Xo, Wo^Xo, Wo^Xo, Wo^Xo, Wo^Xo, Wo, Wo, Ww, Ww, Ww, Ww
Ww, Wo, Ww, Wo, Wo, Wo, Ww, Wo, Wo, Ww, Wo, Wo, Wo, Wo, Ww, Ww, Ww, Ww
Ww, Ww, Ww, Wo, Wo, Wo, Ww, Ww, Wo, Wo, Wo, Wo, Wo, Ww, Wo, Wo, Wo, Ww
