border_size=1
usage=map

_off^_usr   , _off^_usr   , _off^_usr   , _off^_usr   , _off^_usr   , _off^_usr   , _off^_usr   , _off^_usr   , _off^_usr   , _off^_usr   , _off^_usr   , _off^_usr   , _off^_usr   , _off^_usr   , _off^_usr   , _off^_usr   , _off^_usr   , _off^_usr   , Wo          , Wo          , Wo          , Wo          , Wo          , Wo          , Wo          , Wo          , Wo          , Wo          , Wo          , Wo          , Ww          , Wo          , Wo          , Wo          , Wo          , Wo          , Wo          , Wo          , Wo          , Wo          , Wo          , Wo          , Wo          , Wo          
_off^_usr   , _off^_usr   , _off^_usr   , _off^_usr   , _off^_usr   , _off^_usr   , _off^_usr   , _off^_usr   , _off^_usr   , _off^_usr   , _off^_usr   , _off^_usr   , _off^_usr   , _off^_usr   , _off^_usr   , _off^_usr   , _off^_usr   , _off^_usr   , Wo          , Wo          , Wo          , Wo          , Wo          , Wo          , Wo          , Wo          , Wo          , Wo          , Ww          , Ww          , Dd          , Ww          , Ww          , Wo          , Wo          , Wo          , Wo          , Wo          , Wo          , Wo          , Wo          , Wo          , Wo          , Wo          
_off^_usr   , _off^_usr   , _off^_usr   , _off^_usr   , _off^_usr   , _off^_usr   , _off^_usr   , _off^_usr   , _off^_usr   , _off^_usr   , _off^_usr   , _off^_usr   , _off^_usr   , _off^_usr   , _off^_usr   , _off^_usr   , _off^_usr   , _off^_usr   , Wo          , Wo          , Wo          , Wo          , Wo          , Wo          , Wo          , Wo          , Ww          , Ww          , Dd          , Dd          , Dd          , Dd          , Dd          , Ww          , Ww          , Wo          , Wo          , Wo          , Wo          , Wo          , Wo          , Wo          , Wo          , Wo          
_off^_usr   , _off^_usr   , _off^_usr   , _off^_usr   , _off^_usr   , _off^_usr   , _off^_usr   , _off^_usr   , _off^_usr   , _off^_usr   , _off^_usr   , _off^_usr   , _off^_usr   , _off^_usr   , _off^_usr   , _off^_usr   , _off^_usr   , _off^_usr   , Wo          , Wo          , Wo          , Wo          , Wo          , Wo          , Ww          , Ww          , Dd          , Dd          , Wwf         , Wwf         , Dd          , Wwf         , Wwf         , Dd          , Dd          , Ww          , Ww          , Wo          , Wo          , Wo          , Wo          , Wo          , Wo          , Wo          
_off^_usr   , _off^_usr   , _off^_usr   , _off^_usr   , _off^_usr   , 1 _off^_usr , _off^_usr   , 2 _off^_usr , _off^_usr   , _off^_usr   , _off^_usr   , _off^_usr   , _off^_usr   , _off^_usr   , _off^_usr   , _off^_usr   , _off^_usr   , _off^_usr   , Wo          , Wo          , Wo          , Wo          , Ww          , Ww          , Dd          , Dd          , Wwf         , Wwf         , Dd          , Dd          , Dd          , Dd          , Dd          , Wwf         , Wwf         , Dd          , Dd          , Ww          , Ww          , Wo          , Wo          , Wo          , Wo          , Wo          
_off^_usr   , _off^_usr   , _off^_usr   , _off^_usr   , _off^_usr   , _off^_usr   , _off^_usr   , _off^_usr   , _off^_usr   , _off^_usr   , _off^_usr   , _off^_usr   , _off^_usr   , _off^_usr   , _off^_usr   , _off^_usr   , _off^_usr   , _off^_usr   , Wo          , Wo          , Ww          , Ww          , Dd          , Dd          , Wwf         , Wwf         , Dd          , Dd          , Wwf         , Wwf         , Dd          , Wwf         , Wwf         , Dd          , Dd          , Wwf         , Wwf         , Dd          , Dd          , Ww          , Ww          , Wo          , Wo          , Wo          
_off^_usr   , _off^_usr   , _off^_usr   , _off^_usr   , _off^_usr   , _off^_usr   , _off^_usr   , _off^_usr   , _off^_usr   , _off^_usr   , _off^_usr   , _off^_usr   , _off^_usr   , _off^_usr   , _off^_usr   , _off^_usr   , _off^_usr   , _off^_usr   , Wo          , Ww          , Dd          , Dd          , Wwf         , Wwf         , Dd          , Dd          , Wwf         , Wwf         , Dd          , Dd          , Dd          , Dd          , Dd          , Wwf         , Wwf         , Dd          , Dd          , Wwf         , Wwf         , Dd          , Dd          , Ww          , Wo          , Wo          
_off^_usr   , _off^_usr   , _off^_usr   , _off^_usr   , _off^_usr   , _off^_usr   , _off^_usr   , _off^_usr   , _off^_usr   , _off^_usr   , _off^_usr   , _off^_usr   , _off^_usr   , _off^_usr   , _off^_usr   , _off^_usr   , _off^_usr   , _off^_usr   , Wo          , Ww          , Dd          , Dd          , Dd          , Dd          , Wwf         , Wwf         , Dd          , Dd          , Wwf         , Wwf         , Dd          , Wwf         , Wwf         , Dd          , Dd          , Wwf         , Wwf         , Dd          , Dd          , Dd          , Dd          , Ww          , Wo          , Wo          
_off^_usr   , _off^_usr   , _off^_usr   , _off^_usr   , _off^_usr   , _off^_usr   , _off^_usr   , _off^_usr   , _off^_usr   , _off^_usr   , _off^_usr   , _off^_usr   , _off^_usr   , _off^_usr   , _off^_usr   , _off^_usr   , _off^_usr   , _off^_usr   , Wo          , Ww          , Dd          , Wwf         , Dd          , Dd          , Dd          , Dd          , Wwf         , Wwf         , Dd          , Dd          , Dd          , Dd          , Dd          , Wwf         , Wwf         , Dd          , Dd          , Dd          , Dd          , Wwf         , Dd          , Ww          , Wo          , Wo          
_off^_usr   , _off^_usr   , _off^_usr   , _off^_usr   , _off^_usr   , _off^_usr   , _off^_usr   , _off^_usr   , _off^_usr   , _off^_usr   , _off^_usr   , _off^_usr   , _off^_usr   , _off^_usr   , _off^_usr   , _off^_usr   , _off^_usr   , _off^_usr   , Wo          , Ww          , Dd          , Wwf         , Dd          , Wwf         , Dd          , Dd          , Dd          , Dd          , Wwf         , Wwf         , Dd          , Wwf         , Wwf         , Dd          , Dd          , Dd          , Dd          , Wwf         , Dd          , Wwf         , Dd          , Ww          , Wo          , Wo          
_off^_usr   , _off^_usr   , _off^_usr   , _off^_usr   , _off^_usr   , _off^_usr   , _off^_usr   , _off^_usr   , _off^_usr   , _off^_usr   , _off^_usr   , _off^_usr   , _off^_usr   , _off^_usr   , _off^_usr   , _off^_usr   , _off^_usr   , _off^_usr   , Wo          , Ww          , Dd          , Wwf         , Dd          , Wwf         , Dd          , Wwf         , Dd          , Dd          , Dd          , Dd          , Wwf         , Dd          , Dd          , Dd          , Dd          , Wwf         , Dd          , Wwf         , Dd          , Wwf         , Dd          , Ww          , Wo          , Wo          
_off^_usr   , _off^_usr   , _off^_usr   , _off^_usr   , _off^_usr   , _off^_usr   , _off^_usr   , _off^_usr   , _off^_usr   , _off^_usr   , _off^_usr   , _off^_usr   , _off^_usr   , _off^_usr   , _off^_usr   , _off^_usr   , _off^_usr   , _off^_usr   , Wo          , Ww          , Dd          , Wwf         , Dd          , Wwf         , Dd          , Wwf         , Dd          , Wwf         , Dd          , Wwf         , Dd          , Wwf         , Dd          , Wwf         , Dd          , Wwf         , Dd          , Wwf         , Dd          , Wwf         , Dd          , Ww          , Wo          , Wo          
_off^_usr   , _off^_usr   , _off^_usr   , _off^_usr   , _off^_usr   , _off^_usr   , _off^_usr   , _off^_usr   , _off^_usr   , _off^_usr   , _off^_usr   , _off^_usr   , _off^_usr   , _off^_usr   , _off^_usr   , _off^_usr   , _off^_usr   , _off^_usr   , Wo          , Ww          , Dd          , Wwf         , Dd          , Wwf         , Dd          , Wwf         , Dd          , Wwf         , Dd          , Wwf         , Wwf         , Wwf         , Dd          , Wwf         , Dd          , Wwf         , Dd          , Wwf         , Dd          , Wwf         , Dd          , Ww          , Wo          , Wo          
_off^_usr   , _off^_usr   , _off^_usr   , _off^_usr   , _off^_usr   , _off^_usr   , _off^_usr   , _off^_usr   , _off^_usr   , _off^_usr   , _off^_usr   , _off^_usr   , _off^_usr   , _off^_usr   , _off^_usr   , _off^_usr   , _off^_usr   , _off^_usr   , Wo          , Ww          , Dd          , Wwf         , Dd          , Wwf         , Dd          , Wwf         , Dd          , Dd          , Wwf         , Dd          , Dd          , Dd          , Wwf         , Dd          , Dd          , Wwf         , Dd          , Wwf         , Dd          , Wwf         , Dd          , Ww          , Wo          , Wo          
_off^_usr   , _off^_usr   , _off^_usr   , _off^_usr   , _off^_usr   , _off^_usr   , _off^_usr   , _off^_usr   , _off^_usr   , _off^_usr   , _off^_usr   , _off^_usr   , _off^_usr   , _off^_usr   , _off^_usr   , _off^_usr   , _off^_usr   , _off^_usr   , Wo          , Ww          , Dd          , Wwf         , Dd          , Wwf         , Dd          , Dd          , Wwf         , Dd          , Dd          , Wwf         , Dd          , Wwf         , Dd          , Dd          , Wwf         , Dd          , Dd          , Wwf         , Dd          , Wwf         , Dd          , Ww          , Wo          , Wo          
_off^_usr   , _off^_usr   , _off^_usr   , _off^_usr   , _off^_usr   , _off^_usr   , _off^_usr   , _off^_usr   , _off^_usr   , _off^_usr   , _off^_usr   , _off^_usr   , _off^_usr   , _off^_usr   , _off^_usr   , _off^_usr   , _off^_usr   , _off^_usr   , Wo          , Ww          , Dd          , Wwf         , Dd          , Dd          , Wwf         , Dd          , Dd          , Wwf         , Wwf         , Dd          , Dd          , Dd          , Wwf         , Wwf         , Dd          , Dd          , Wwf         , Dd          , Dd          , Wwf         , Dd          , Ww          , Wo          , Wo          
_off^_usr   , _off^_usr   , _off^_usr   , _off^_usr   , _off^_usr   , _off^_usr   , _off^_usr   , _off^_usr   , _off^_usr   , _off^_usr   , _off^_usr   , _off^_usr   , _off^_usr   , _off^_usr   , _off^_usr   , _off^_usr   , _off^_usr   , _off^_usr   , Wo          , Ww          , Dd          , Dd          , Wwf         , Dd          , Dd          , Wwf         , Wwf         , Dd          , Dd          , Wwf         , Dd          , Wwf         , Dd          , Dd          , Wwf         , Wwf         , Dd          , Dd          , Wwf         , Dd          , Dd          , Ww          , Wo          , Wo          
_off^_usr   , _off^_usr   , _off^_usr   , _off^_usr   , _off^_usr   , _off^_usr   , _off^_usr   , _off^_usr   , _off^_usr   , _off^_usr   , _off^_usr   , _off^_usr   , _off^_usr   , _off^_usr   , _off^_usr   , _off^_usr   , _off^_usr   , _off^_usr   , Wo          , Ww          , Ww          , Dd          , Dd          , Wwf         , Wwf         , Dd          , Dd          , Wwf         , Wwf         , Dd          , Dd          , Dd          , Wwf         , Wwf         , Dd          , Dd          , Wwf         , Wwf         , Dd          , Dd          , Ww          , Ww          , Wo          , Wo          
_off^_usr   , _off^_usr   , _off^_usr   , _off^_usr   , _off^_usr   , _off^_usr   , _off^_usr   , _off^_usr   , _off^_usr   , _off^_usr   , _off^_usr   , _off^_usr   , _off^_usr   , _off^_usr   , _off^_usr   , _off^_usr   , _off^_usr   , _off^_usr   , Wo          , Wo          , Wo          , Ww          , Ww          , Dd          , Dd          , Wwf         , Wwf         , Dd          , Dd          , Wwf         , Dd          , Wwf         , Dd          , Dd          , Wwf         , Wwf         , Dd          , Dd          , Ww          , Ww          , Wo          , Wo          , Wo          , Wo          
_off^_usr   , _off^_usr   , _off^_usr   , _off^_usr   , _off^_usr   , _off^_usr   , _off^_usr   , _off^_usr   , _off^_usr   , _off^_usr   , _off^_usr   , _off^_usr   , _off^_usr   , _off^_usr   , _off^_usr   , _off^_usr   , _off^_usr   , _off^_usr   , Wo          , Wo          , Wo          , Wo          , Wo          , Ww          , Ww          , Dd          , Dd          , Wwf         , Wwf         , Dd          , Dd          , Dd          , Wwf         , Wwf         , Dd          , Dd          , Ww          , Ww          , Wo          , Wo          , Wo          , Wo          , Wo          , Wo          
_off^_usr   , _off^_usr   , _off^_usr   , _off^_usr   , _off^_usr   , _off^_usr   , _off^_usr   , _off^_usr   , _off^_usr   , _off^_usr   , _off^_usr   , _off^_usr   , _off^_usr   , _off^_usr   , _off^_usr   , _off^_usr   , _off^_usr   , _off^_usr   , Wo          , Wo          , Wo          , Wo          , Wo          , Wo          , Wo          , Ww          , Ww          , Dd          , Dd          , Wwf         , Dd          , Wwf         , Dd          , Dd          , Ww          , Ww          , Wo          , Wo          , Wo          , Wo          , Wo          , Wo          , Wo          , Wo          
_off^_usr   , _off^_usr   , _off^_usr   , _off^_usr   , _off^_usr   , _off^_usr   , _off^_usr   , _off^_usr   , _off^_usr   , _off^_usr   , _off^_usr   , _off^_usr   , _off^_usr   , _off^_usr   , _off^_usr   , _off^_usr   , _off^_usr   , _off^_usr   , Wo          , Wo          , Wo          , Wo          , Wo          , Wo          , Wo          , Wo          , Wo          , Ww          , Ww          , Dd          , Dd          , Dd          , Ww          , Ww          , Wo          , Wo          , Wo          , Wo          , Wo          , Wo          , Wo          , Wo          , Wo          , Wo          
_off^_usr   , _off^_usr   , _off^_usr   , _off^_usr   , _off^_usr   , _off^_usr   , _off^_usr   , _off^_usr   , _off^_usr   , _off^_usr   , _off^_usr   , _off^_usr   , _off^_usr   , _off^_usr   , _off^_usr   , _off^_usr   , _off^_usr   , _off^_usr   , Wo          , Wo          , Wo          , Wo          , Wo          , Wo          , Wo          , Wo          , Wo          , Wo          , Wo          , Ww          , Ww          , Ww          , Wo          , Wo          , Wo          , Wo          , Wo          , Wo          , Wo          , Wo          , Wo          , Wo          , Wo          , Wo          
_off^_usr   , _off^_usr   , _off^_usr   , _off^_usr   , _off^_usr   , _off^_usr   , _off^_usr   , _off^_usr   , _off^_usr   , _off^_usr   , _off^_usr   , _off^_usr   , _off^_usr   , _off^_usr   , _off^_usr   , _off^_usr   , _off^_usr   , _off^_usr   , Wo          , Wo          , Wo          , Wo          , Wo          , Wo          , Wo          , Wo          , Wo          , Wo          , Wo          , Wo          , Wo          , Wo          , Wo          , Wo          , Wo          , Wo          , Wo          , Wo          , Wo          , Wo          , Wo          , Wo          , Wo          , Wo          
