Xos, Xos, Xos, Xos, Xos, Xos, Xos, Xos, Xos, Xos, Xos, Xos, Xos, Xos, Xos, Xos, Xos, Xos, Xos, Xos, Xos, Xos, Xos, Xos, Xos, Xos, Xos, Xos, Xos, Xos, Xos, Xos, Xos, Xos, Xos, Xos, Xos, Xos, Xos, Xos, Xos, Xos, Xos, Xos, Xos, Xos, Xos, Xos, Xos, Xos, Xos, Xos, Xos, Xos, Xos
Xos, Xos, Xos, Xos, Xos, Xos, Xos, Xos, Xos, Xos, Xos, Xos, Xos, Xos, Xos, Xos, Xos, Xos, Xos, Xos, Xos, Xos, Xos, Xos, Xos, Xos, Aa, Xos, Xos, Xos, Xos, Xos, Xos, Xos, Xos, Xos, Xos, Xos, Xol, Xos, Xos, Xos, Xos, Xos, Xos, Xos, Xos, Xos, Xos, Xos, Xos, Xos, Xos, Xos, Xos
Xos, Xos, Xos, Xos, Xos, Xos, Xos, Xos, Xos, Xos, Xos, Xos, Xos, Xos, Xos, Xos, Xos, Xos, Xos, Xos, Xos, Xos, Xos, Xos, Aa, Aa, Qxu, Aa, Aa, Xos, Xos, Xos, Xos, Xos, Xos, Xos, Xos, Xos, Ur^Ii, Urb, Urb, Xos, Xos, Xos, Xos, Xos, Zfbp, Ur, Zfbp^Vu, Xos, Xos, Xos, Xos, Xos, Xos
Xos, Xos, Xos, Xos, Xos, Xos, Xos, Xos, Xos, Xos, Xos, Xos, Xos, Xos, Xos, Xos, Xos, Xos, Xos, Xos, Xos, Xos, Aa, Aa, Qxu, Qxu, Urb, Qxu, Qxu, Aa, Aa, Xos, Xos, Xos, Xos, Xos, Ur^Ii, Urb, Urb, Urb, Qxu, Qxu, Zfbp, Xos, Xos, Zfbp, Zfbp, Zfbp, Zfbp, Zfbp, Zfbp, Xos, Xos, Xos, Xos
Xos, Xos, Xos, Xos, Xos, Xos, Xos, Xos, Xos, Xos, Xos, Xos, Xos, Xos, Xos, Xos, Xos, Xos, Xos, Xos, Aa, Aa, Qxu, Qxu, Urb, Urb, Urb, Urb, Urb, Qxu, Qxu, Aa, Aa, Xos, Xos, Urb, Urb, Urb, Qxu, Qxu, Zfbp, Zfbp, Chw, Chw, Zfbp, Xos, Zfbp, Zfbp, Zfbp, Zfbp, Zfbp, Zfbp^Vu, Ur, Xos, Xos
Xos, Xos, Xos, Xos, Xos, Xos, Xos, Xos, Xos, Xos, Xos, Xos, Xos, Xos, Xos, Xos, Xos, Xos, Aa, Aa, Qxu, Qxu, Urb, Urb, Urb, Urb, Urb, Urb, Qxu^Bs\, Qxu, Aa, Aa, Xos, Xos, Xos, Xos, Xos, Qxu, Zfbp, Zfbp, Chw, Chw, Zfbp, Zfbp, Zfbp, Zfbp, Xos, Zfbp, Zfbp, Zfbp, Zfbp, Zfbp, Xos, Xos, Xos
Xos, Xos, Xos, Xos, Xos, Xos, Xos, Xos, Xos, Xos, Xos, Xos, Xos, Xos, Xos, Xos, Xos, Xos, Xos, Aa, Aa, Qxu, Qxu, Urb, Urb, Urb, Qxu^Bs\, Qxu, Ur^Xo, Ur^Xo, Xol, Xol, Zfbp, Zfbp^Vu, Zfbp, Xos, Xos, Xos, Xos, Chw, Zfbp, Zfbp, Zfbp, Zfbp, Xos, Xos, Xos, Xos, Xos, Zfbp, Zfbp^Pw/o, Xol, Xol, Xos, Xos
Xos, Xos, Xos, Xos, Xos, Xos, Xos, Xos, Xos, Xos, Xos, Xos, Xos, Xos, Xos, Xos, Xos, Xos, Xos, Xos, Xos, Aa, Aa, Qxu, Qxu, Qxu, Aa, Ur^Xo, Xol, Ur^Pw/, Zfbp, Zfbp, Zfbp, Xol, Xol, Zfbp, Zfbp^Dr, Xos, Xos, Xos, Xos, Zfbp, Xol, Zfbp^Pw/o, Zfbp, Xos, Xos, Xos, Xos, Xos, Xos, Zfbp, Chw, Xos, Xos
Xos, Xos, Xos, Xos, Xos, Xos, Xos, Xos, Xos, Xos, Xos, Xos, Xos, Xos, Xos, Xos, Xos, Xos, Xos, Xos, Xos, Xos, Xos, Aa, Aa, Aa, Xos, Xol, Zfbp, Zfbp, Zfbp, Zfbp, Zfbp, Zfbp, Zfbp, Xol, Zfbp, Zfbp, Zfbp, Xos, Xos, Xol, Zfbp, Zfbp, Zfbp, Zfbp, Zfbp, Xos, Xos, Xos, Chw, Zfbp, Chw, Xos, Xos
Xos, Xos, Xos, Xos, Xos, Xos, Xos, Xos, Xos, Xos, Xos, Xos, Xos, Xos, Xos, Xos, Xos, Xos, Xos, Xos, Xos, Xos, Xos, Xos, Xos, Xos, Xos, Zfbp^Vu, Zfbp, Xol, Xol, Zfbp, Zfbp, Zfbp, Zfbp, Zfbp, Zfbp, Xol, Xol, Zfbp, Zfbp, Xos, Xos, Zfbp^Dr, Zfbp, Xos, Zfbp, Zfbp, Xos, Xos, Chw, Zfbp, Xol, Xos, Xos
Xos, Xos, Xos, Xos, Xos, Xos, Xos, Xos, Xos, Xos, Xos, Xos, Xos, Xos, Xos, Xos, Xos, Xos, Xos, Xos, Xos, Xos, Xos, Xos, Zfbp, Xol, Xol, Xos, Xos, Zfbp, Zfbp, Xol, Zfbp, Zfbp, Zfbp, Zfbp, Zfbp, Zfbp, Zfbp, Xol, Zfbp, Zfbp, Zfbp, Zfbp^Pw\o, Xos, Zfbp, Xos, Xos, Xos, Xos, Xos, Zfbp, Zfbp, Xol, Xos
Xos, Xos, Xos, Xos, Xos, Xos, Xos, Xos, Xos, Xos, Xos, Xos, Xos, Xos, Xos, Xos, Xos, Xos, Xos, Xos, Xos, Xos, Zfbp, Xol, Xol, Zfbp^Pr/, Zfbp, Zfbp, Zfbp, Zfbp^Pr\, Xos, Zfbp, Zfbp, Xol, Xol, Zfbp, Zfbp, Zfbp, Zfbp, Zfbp, Zfbp, Xol, Xol, Zfbp, Zfbp, Xos, Xos, Xos, Xol, Xol, Zfbp, Zfbp, Zfbp, Chw, Xos
Xos, Xos, Xos, Xos, Xos, Xos, Xos, Xos, Xos, Xos, Xos, Xos, Xos, Xos, Xos, Xos, Xos, Xos, Xos, Xos, Zfbp, Xol, Xol, Zfbp^Pr/, Zfbp, Zfbp, Zfbp, Chw, Xos, Xos, Wwg, Xos, Chw, Zfbp, Zfbp, Xol, Zfbp, Zfbp, Zfbp, Zfbp, Zfbp, Zfbp, Zfbp, Xol, Zfbp, Zfbp, Zfbp, Xos, Zfbp, Zfbp, Zfbp, 1 Zfbp, Zfbp, Chw, Xos
Xos, Xos, Xos, Xos, Xos, Xos, Xos, Xos, Xos, Xos, Xos, Xos, Xos, Xos, Xos, Xos, Xos, Xos, Xos, Xos, Xos, Zfbp^Pr/, Zfbp, Zfbp, Zfbp, Chw, Xos, Xos, Wwg, Wwf, Wwg, Chw, Chw, Xos, Xos, Zfbp, Zfbp, Xol, Xol, Zfbp, Zfbp, Zfbp, Zfbp, Zfbp, Zfbp, Chw, Zfbp, Zfbp, Zfbp, Zfbp, Zfbp, Zfbp, Zfbp, Khw, Xos
Xos, Xos, Xos, Xos, Xos, Xos, Xos, Xos, Xos, Xos, Xos, Xos, Xos, Xos, Xos, Xos, Xos, Xos, Xos, Xos, Xos, Xos, Xos, Chw, Xos, Xos, Ai, Wwg, Wwg, Ai, Wwg, Wwg, Wwg, Wwf, Ai, Xos, Xos, Zfbp, Zfbp, Xol, Zfbp, Zfbp, Zfbp, Chw, Zfbp, Zfbp, Xos, Xos, Xos, Zfbp, Zfbp, 2 Zfbp, Zfbp, Chw, Xos
Xos, Xos, Xos, Xos, Xos, Xos, Xos, Xos, Xos, Xos, Xos, Xos, Xos, Xos, Xos, Xos, Xos, Xos, Xos, Xos, Xos, Xos, Xos, Xos, Xos, Wog, Ai, Wwg, Ai, Wwf, Ai, Wwf, Wwg, Ai, Xos, Xos, Zfbp^Dr, Xos, Zfbp^Pw\o, Zfbp, Zfbp, Chw, Zfbp, Zfbp, Xos, Xos, Xos, Xos, Zfbp, Xol, Xol, Zfbp, Zfbp, Chw, Xos
Xos, Xos, Xos, Xos, Xos, Xos, Xos, Xos, Xos, Xos, Xos, Xos, Xos, Xos, Xos, Xos, Xos, Xos, Xos, Xos, Xos, Xos, Xos, Xos, Xos, Xos, Xos, Wwg, Wwf, Ai, Ai, Wwg, Xos, Xos, Zfbp, Zfbp, Zfbp, Zfbp, Zfbp, Xol, Xol, Zfbp, Xos, Xos, Xos, Xos, Zfbp, Zfbp, Zfbp, Zfbp, Zfbp, Zfbp^Pw\o, Xol, Xos, Xos
Xos, Xos, Xos, Xos, Xos, Xos, Xos, Xos, Xos, Xos, Xos, Xos, Xos, Xos, Xos, Xos, Xos, Xos, Xos, Xos, Xos, Xos, Xos, Xos, Xos, Xos, Xos, Xos, Xos, Ai, Xos, Xol, Zfbp, Zfbp, Zfbp, Zfbp, Zfbp, Zfbp, Zfbp, Zfbp, Zfbp^Vu, Xos, Xol, Xos, Zfbp, Zfbp, Zfbp, Zfbp, Zfbp, Zfbp, Zfbp, Zfbp, Zfbp, Xol, Xos
Xos, Xos, Xos, Xos, Xos, Xos, Xos, Xos, Xos, Xos, Xos, Xos, Xos, Xos, Xos, Xos, Xos, Xos, Xos, Xos, Xos, Xos, Xos, Xos, Xos, Xos, Xos, Xos, Xos, Xos, Xos, Zfbp, Zfbp, Zfbp, Zfbp, Zfbp, Zfbp, Zfbp, Zfbp, Zfbp, Zfbp^Pw/o, Xol, Zfbp, Zfbp, Zfbp, Zfbp, Zfbp, Zfbp, Zfbp, Zfbp, Zfbp, Zfbp, Zfbp, Zfbp, Xos
Xos, Xos, Xos, Xos, Xos, Xos, Xos, Xos, Xos, Xos, Xos, Xos, Xos, Xos, Xos, Xos, Xos, Xos, Xos, Xos, Xos, Xos, Xos, Xos, Xos, Xos, Xos, Xos, Xos, Xos, Xos, Xos, Xos, Zfbp, Zfbp, Zfbp, Zfbp, Zfbp, Xol, Xol, Zfbp, Zfbp, Zfbp, Zfbp, Zfbp, Zfbp, Zfbp, Zfbp, Zfbp, Zfbp, Zfbp, Zfbp, Xos, Xos, Xos
Xos, Xos, Xos, Xos, Xos, Xos, Xos, Xos, Xos, Xos, Xos, Xos, Xos, Xos, Xos, Xos, Xos, Xos, Xos, Xos, Xos, Xos, Xos, Xos, Xos, Xos, Xos, Xos, Xos, Xos, Xos, Xos, Xos, Xos, Xos, Zfbp, Xos, Xos, Zfbp, Zfbp, Zfbp, Zfbp, Zfbp, Zfbp, Zfbp, Zfbp, Zfbp, Zfbp, Zfbp, Zfbp, Xos, Xos, Xos, Xos, Xos
Xos, Xos, Xos, Xos, Xos, Xos, Xos, Xos, Xos, Xos, Xos, Xos, Xos, Xos, Xos, Xos, Xos, Xos, Xos, Xos, Xos, Xos, Xos, Xos, Xos, Xos, Xos, Xos, Xos, Xos, Xos, Xos, Xos, Xos, Xos, Xos, Xos, Zfbp, Zfbp, Zfbp, Zfbp, Zfbp, Zfbp, Zfbp, Zfbp, Zfbp, Zfbp, Zfbp, Xos, Xos, Xos, Xos, Xos, Xos, Xos
Xos, Xos, Xos, Xos, Xos, Xos, Xos, Xos, Xos, Xos, Xos, Xos, Xos, Xos, Xos, Xos, Xos, Xos, Xos, Xos, Xos, Xos, Xos, Xos, Xos, Xos, Xos, Xos, Xos, Xos, Xos, Xos, Xos, Xos, Xos, Xos, Xos, Xos, Xos, Zfbp, Zfbp, Zfbp, Zfbp, Zfbp, Zfbp, Zfbp, Xos, Xos, Xos, Xos, Xos, Xos, Xos, Xos, Xos
Xos, Xos, Xos, Xos, Xos, Xos, Xos, Xos, Xos, Xos, Xos, Xos, Xos, Xos, Xos, Xos, Xos, Xos, Xos, Xos, Xos, Xos, Xos, Xos, Xos, Xos, Xos, Xos, Xos, Xos, Xos, Xos, Xos, Xos, Xos, Xos, Xos, Xos, Xos, Xos, Xos, Zfbp, Zfbp, Zfbp, Xos, Xos, Xos, Xos, Xos, Xos, Xos, Xos, Xos, Xos, Xos
Xos, Xos, Xos, Xos, Xos, Xos, Xos, Xos, Xos, Xos, Xos, Xos, Xos, Xos, Xos, Xos, Xos, Xos, Xos, Xos, Xos, Xos, Xos, Xos, Xos, Xos, Xos, Xos, Xos, Xos, Xos, Xos, Xos, Xos, Xos, Xos, Xos, Xos, Xos, Xos, Xos, Xos, Xos, Xos, Xos, Xos, Xos, Xos, Xos, Xos, Xos, Xos, Xos, Xos, Xos
Xos, Xos, Xos, Xos, Xos, Xos, Xos, Xos, Xos, Xos, Xos, Xos, Xos, Xos, Xos, Xos, Xos, Xos, Xos, Xos, Xos, Xos, Xos, Xos, Xos, Xos, Xos, Xos, Xos, Xos, Xos, Xos, Xos, Xos, Xos, Xos, Xos, Xos, Xos, Xos, Xos, Xos, Xos, Xos, Xos, Xos, Xos, Xos, Xos, Xos, Xos, Xos, Xos, Xos, Xos
