Xoi, Xoi, Xoi, Xoi, Xoi, Xoi, Xoi, Xoi, Xoi, Xoi, Xoi, Xoi, Xoi, Xoi, Xoi, Xoi, Xoi, Xoi, Xoi, Xoi, Xoi, Xoi, Xoi, Xoi, Xoi, Xoi, Xoi, Xoi, Xoi, Xoi, Xoi, Xoi, Xoi, Xoi, Xoi, Xoi, Xoi
Xoi, Xoi, Xoi, Xoi, Xoi, Xoi, Xoi, Xoi, Xoi, Xoi, Xoi, Xoi, Xoi, Xoi, Xoi, Xoi, Xoi, Xoi, Xoi^Efs, Xoi, Xoi^Efs, Xoi, Xoi, Xoi, Xoi, Xoi, Xoi, Xoi, Xoi, Xoi, Xoi, Xoi, Xoi, Xoi, Xoi, Xoi, Xoi
Xoi, Xoi, Xoi, Xoi, Xoi, Xoi, Zstl^Es, Xoi, Xoi, Xoi, Xoi, Xoi, Xoi, Xoi, Xoi, Xoi, Zstl, Zstl, Zstl, Zstl, Zstl, Zstl, Zstl, Xoi, Xoi, Xoi, Xoi, Xoi, Xoi, Xoi, Xoi, Xoi, Xoi, Xoi, Xoi, Xoi, Xoi
Xoi, Xoi, Xoi, Xoi^Efs, Zstl^Dr, Zstl^Es, Zstl^Es, Zstl^Dr, Zstl, Xoi, Xoi, Xoi, Xoi, Xoi, Xoi, Zstl, Zstl, Zstl, Zstl, Zstl^Pw|o, Zstl, Zstl, Zstl, Zstl, Xoi, Xoi, Xoi, Xoi, Xoi, Xoi, Xoi, Xoi, Xoi, Xoi, Xoi, Xoi, Xoi
Xoi, Xoi, Xoi, Zstl^Dr, Zstl^Es, 1 Zstl^Es, Zstl^Es, 2 Zstl^Es, Zstl^Es, Zstl^Es, Xoi, Xoi, Xoi, Xoi, Xoi, Zstl, Zstl, Zstl, Qxua, Zstl, Qxua, Zstl, Zstl, Zstl, Xoi, Xoi, Xoi, Xoi, Xoi, Xoi, Zstl, Zstl, Zstl, Xoi, Xoi, Xoi, Xoi
Xoi, Xoi, Xoi, Zstl^Es, Zstl^Es, Zstl^Es, Zstl, Zstl^Es, Zstl^Dr, Zstl^Dr, Xoi, Xoi, Xoi, Xoi, Xoi, Xoi, Zstl, Qxua, Qxua, Qxua, Qxua, Qxua, Zstl, Xoi, Xoi, Xoi, Xoi, Xoi, Xoi, Xoi, Zstl, Zstl^Pw|o, Zstl, Xoi, Xoi, Xoi, Xoi
Xoi, Xoi, Xoi, Zstl^Dr, Zstl^Es, Zstl^Es, Zstl^Es, Zstl^Es, Zstl^Es, Zstl^Es, Xoi, Xoi, Xoi, Xoi, Xoi, Zstl, Qxua, Qxu^Bs\, Zstl, Zstl, Zstl, Qxu^Bs/, Qxua, Zstl, Xoi, Xoi, Xoi, Xoi, Xoi, Xoi, Zstl, Zstl, Zstl, Xoi, Xoi, Xoi, Xoi
Xoi, Xoi, Xoi, Zstl, Zstl^Dr, Zstl^Es, Zstl, Zstl^Es, Zstl^Es, Zstl^Dr, Xoi, Xoi, Xoi, Xoi, Zstl^Ztv, Zstl, Qxua, Qxua, Zstl, Zstl, Zstl, Qxua, Qxua, Zstl, Zstl^Ztv, Xoi, Xoi, Xoi, Xoi, Zstl^Ztv, Zstl, Zstl, Zstl, Zstl^Ztv, Xoi, Xoi, Xoi
Xoi, Xoi, Xoi, Xoi, Xoi, Zstl, Zstl^Pw|, Zstl, Xoi, Xoi, Xoi, Xoi, Xoi, Xoi, Xoi, Zstl, Zstl, Qxu^Bs/, Qxua, Zstl, Qxua, Qxu^Bs\, Zstl, Zstl, Xoi, Xoi, Xoi, Xoi, Xoi, Xoi, Zstl, Zstl, Zstl, Xoi, Xoi, Xoi, Xoi
Xoi, Xoi, Xoi, Xoi, Xoi, Zstl, Zstl, Zstl, Xoi, Xoi, Xoi, Xoi, Xoi, Xoi, Zstl, Zstl, Zstl, Qxua, Qxua, Qxua, Qxua, Qxua, Zstl, Zstl, Zstl, Xoi, Xoi, Xoi, Xoi, Xoi, Zstl, Zstl^Pw|, Zstl, Xoi, Xoi, Xoi, Xoi
Xoi, Xoi, Xoi, Xoi, Xoi, Xoi, Xoi, Xoi, Xoi, Xoi, Xoi, Xoi, Xoi, Xoi, Xoi, Xoi, Xoi, Zstl, Zstl, Zstl, Zstl, Zstl, Xoi, Xoi, Xoi, Xoi, Xoi, Xoi, Xoi, Xoi, Xoi, Zstl, Xoi, Xoi, Xoi, Xoi, Xoi
Xoi, Xoi, Xoi, Xoi, Xoi, Xoi, Xoi^Efs, Xoi, Xoi, Xoi, Xoi, Xoi, Xoi, Xoi, Xoi, Xoi, Xoi, Xoi^Efs, Zstl, Zstl^Pw|, Zstl, Xoi^Efs, Xoi, Xoi, Xoi, Xoi, Xoi, Xoi, Xoi, Xoi, Xoi, Xoi, Xoi, Xoi, Xoi, Xoi, Xoi
Xoi, Xoi, Xoi, Xoi, Rb^Edb, Rb^Edb, Zstl, Rb^Edb, Rb^Edb, Xoi, Xoi, Xoi, Xoi, Xoi, Xoi, Xoi, Xoi, Xoi, Xoi, Zstl, Xoi, Xoi, Xoi, Xoi, Xoi, Xoi, Xoi, Xoi, Xoi, Xoi, Xoi, Xoi, Xoi, Xoi, Xoi, Xoi, Xoi
Xoi, Xoi, Xoi, Xoi, Xoi, Rb^Edb, Zstl, Rb^Edb, Xoi, Xoi, Xoi, Xoi, Xoi, Xoi, Xoi, Xoi, Xoi, Xoi, Xoi, Xoi, Xoi, Xoi, Xoi, Xoi, Xoi, Xoi, Xoi, Xoi, Xoi, Xoi, Xoi, Xoi, Xoi, Xoi, Xoi, Xoi, Xoi
Xoi, Xoi, Xoi, Xoi, Rb^Edb, Rb^Edb, Zstl^Pw|, Rb^Edb, Rb^Edb, Xoi, Xoi, Xoi, Xoi, Xoi, Xoi, Xoi, Xoi, Xoi, Zstl, Xoi, Zstl, Xoi, Xoi, Xoi, Xoi, Xoi, Xoi, Xu, Xoi, Xoi, Xoi, Xoi, Xoi, Xoi, Xoi, Xoi, Xoi
Xoi, Xoi, Xoi, Xoi, Xoi, Rb^Edb, Zstl, Rb^Edb, Xoi, Xoi, Xoi, Xoi, Xoi, Xoi, Xoi, Xoi, Xoi^Efs, Xoi, Zstl, Zstl^Ztv, Zstl, Xoi, Xoi^Efs, Xoi, Xoi, Xoi, Xoi, Xoi, Xoi, Xoi, Xoi, Xoi, Xoi, Xoi, Xoi, Xoi, Xoi
Xoi, Xoi, Xoi, Xoi, Xoi, Xoi, Xoi, Xoi, Xoi, Xoi, Xoi, Xoi, Xoi, Xoi, Xoi, Zstl, Zstl, Zstl, Zstl, Zstl, Zstl, Zstl, Zstl, Zstl, Xoi, Xoi, Xoi, Xoi, Xoi, Xoi, Zstl^Pw|o, Xoi, Xoi, Xoi, Xoi, Xoi, Xoi
Xoi, Xoi, Xoi, Xoi, Xoi, Xoi, Xoi^Efs, Xoi, Xoi, Xoi, Xoi, Xoi, Xoi, Xoi, Xoi, Xoi, Zstl, Zstl, Cud, Cud, Cud, Zstl, Zstl, Xoi, Xoi, Xoi, Xoi, Xoi, Zstl, Zstl, Zstl, Zstl, Zstl, Xoi, Xoi, Xoi, Xoi
Xoi, Xoi, Xoi, Xoi, Re^Edb, Re^Edb, Zstl, Re^Edb, Re^Edb, Xoi, Xoi, Xoi, Xoi, Xoi, Xoi, Zstl^Ztv, Zstl, Zstl, Cud, 4 Kud, Cud, Zstl, Zstl, Zstl^Ztv, Xoi, Xoi, Xoi, Xoi, Zstl, Zstl, Zstl, Zstl, Zstl, Xoi, Xoi, Xoi, Xoi
Xoi, Xoi, Xoi, Xoi, Xoi, Re^Edb, Zstl, Re^Edb, Xoi, Xoi, Xoi, Xoi, Xoi, Xoi, Xoi, Xoi, Zstl, Zstl, Zstl, Cud, Zstl, Zstl, Zstl, Xoi, Xoi, Xoi, Xoi, Zstl, Zstl, Zstl, Zstl, Zstl, Zstl, Zstl, Xoi, Xoi, Xoi
Xoi, Xoi, Xoi, Xoi, Re^Edb, Re^Edb, Zstl^Pw|, Re^Edb, Re^Edb, Xoi, Xoi, Xoi, Xoi, Xoi, Xoi, Zstl, Xoi, Zstl, Zstl, Zstl, Zstl, Zstl, Xoi, Zstl, Xoi, Xoi, Xoi, Zstl, Zstl, Zstl, Zstl, Zstl, Zstl, Zstl, Xoi, Xoi, Xoi
Xoi, Xoi, Xoi, Xoi, Xoi, Re^Edb, Zstl, Re^Edb, Xoi, Xoi, Xoi, Xoi, Xoi, Xoi, Xoi, Xoi, Xoi, Xoi, Zstl, Zstl^Pw|o, Zstl, Xoi, Xoi, Xoi, Xoi, Xoi, Xoi, Zstl, Zstl, Zstl, Zstl, Zstl, Zstl, Zstl, Xoi, Xoi, Xoi
Xoi, Xoi, Xoi, Xoi, Xoi, Xoi, Xoi, Xoi, Xoi, Xoi, Xoi, Xoi, Xoi, Xoi, Xoi, Xoi, Xoi, Xoi, Xoi, Zstl, Xoi, Xoi, Xoi, Xoi, Xoi, Xoi, Xoi, Xoi, Xoi, Zstl, Xoi, Zstl, Xoi, Xoi, Xoi, Xoi, Xoi
Xoi, Xoi, Xoi, Xoi, Xoi, Xoi, Xoi^Efs, Xoi, Xoi, Xoi, Xoi, Xoi, Xoi, Xoi, Xoi, Xoi, Xoi, Xoi, Xoi, Zstl, Xoi, Xoi, Xoi, Xoi, Xoi, Xoi, Xoi, Xoi, Xoi, Xoi, Xoi, Xoi, Xoi, Xoi, Xoi, Xoi, Xoi
Xoi, Xoi, Xoi, Xoi, Rd^Edb, Rd^Edb, Zstl, Rd^Edb, Rd^Edb, Xoi, Xoi, Xoi, Xoi, Xoi, Xoi, Xoi, Zstl, Xoi, Xoi, Xoi, Xoi, Xoi, Zstl, Xoi, Xoi, Xoi, Xoi, Xoi, Qxua, Xoi, Xoi, Xoi, Xoi, Xoi, Xoi, Xoi, Xoi
Xoi, Xoi, Xoi, Xoi, Xoi, Rd^Edb, Zstl, Rd^Edb, Xoi, Xoi, Xoi, Xoi, Xoi, Xoi, Zstl, Zstl, Zstl, Zstl, Zstl, Zstl, Zstl, Zstl, Zstl^Dr, Zstl, Zstl, Xoi, Xoi, Qxua, Qxua, Qxua, Xoi, Xoi, Xoi, Xoi, Xoi, Xoi, Xoi
Xoi, Xoi, Xoi, Xoi, Rd^Edb, Rd^Edb, Zstl^Pw|, Rd^Edb, Rd^Edb, Xoi, Xoi, Xoi, Xoi, Xoi, Zstl, Cud, Zstl, Zstl^Edt, Zstl^Es, Zstl^Dr, Zstl^Edb, Zstl, Zstl, Cud, Zstl, Xoi, Xoi, Qxua, Zstl, Qxua, Xoi, Xoi, Xoi, Xoi, Xoi, Xoi, Xoi
Xoi, Xoi, Xoi, Xoi, Xoi, Rd^Edb, Zstl, Rd^Edb, Xoi, Xoi, Xoi, Xoi, Xoi, Xoi, Zstl^Edb, Zstl, Zstl^Ztv, Xoi^Efs, Zstl, Zstl^Pw|o, Zstl^Es, Xoi^Efs, Zstl^Ztv, Zstl^Es, Zstl^Edb, Xoi, Xoi, Xoi, Zstl, Xoi, Xoi, Xoi, Xoi, Xoi, Xoi, Xoi, Xoi
Xoi, Xoi, Xoi, Xoi, Xoi, Xoi, Xoi, Xoi, Xoi, Xoi, Xoi, Xoi, Xoi, Xoi, Xoi, Zstl, Zstl, Zstl^Dr, Zstl, Zstl, Zstl, Zstl, Zstl^Edt, Zstl, Xoi, Xoi, Xoi, Zstl, Zstl, Zstl, Xoi, Xoi, Xoi, Xoi, Xoi, Xoi, Xoi
Xoi, Xoi, Xoi, Xoi, Xoi, Xoi, Xoi, Xoi, Xoi, Xoi, Xoi^Efs, Xoi, Xoi^Efs, Xoi, Xoi, Xoi, Xoi, Zstl^Es, Zstl, Zstl, Zstl, Zstl^Dr, Xoi, Xoi, Xoi, Xoi, Xoi, Xoi, Zstl, Xoi, Xoi, Xoi, Xoi, Xoi, Xoi, Xoi, Xoi
Xoi, Xoi, Xoi, Xoi, Xoi, Xoi, Xoi, Xoi, Xoi, Zstl, Zstl, Zstl, Zstl, Zstl, Xoi, Xoi, Xoi, Zstl^Dr, Zstl^Ztv, Xoi^Efs, Zstl^Ztv, Zstl, Xoi, Xoi, Xoi, Xoi, Xoi, Zstl, Zstl^Pw|o, Zstl, Xoi, Xoi, Xoi, Xoi, Xoi, Xoi, Xoi
Xoi, Xoi, Xoi, Xoi, Xoi, Xoi, Xoi, Xoi, Zstl^Ztv, Zstl, Zstl, Zstl, Zstl, Zstl, Zstl^Ztv, Xoi, Xoi, Zstl^Edb, Zstl^Dr, Zstl, Zstl^Edb, Zstl, Xoi, Xoi, Xoi, Xoi, Zstl^Ztv, Zstl, Zstl, Zstl, Zstl^Ztv, Xoi, Xoi, Xoi, Xoi, Xoi, Xoi
Xoi, Xoi, Xoi, Xoi, Xoi, Xoi, Xoi, Xoi, Xoi, Zstl, Zstl, Zstl^Pw|o, Zstl, Zstl, Xoi, Xoi, Xoi, Zstl, Zstl, Cud, Zstl, Zstl^Edt, Xoi, Xoi, Xoi, Xoi, Zstl, Zstl, Zstl, Zstl, Zstl, Xoi, Xoi, Xoi, Xoi, Xoi, Xoi
Xoi, Xoi, Xoi, Xoi, Xoi, Xoi, Xoi, Xoi, Zstl, Zstl, Zstl, Zstl, Zstl, Zstl, Zstl, Xoi, Xoi, Xoi, Xoi, Zstl, Xoi, Xoi, Xoi, Xoi, Xoi, Xoi, Zstl, Zstl, Zstl, Zstl, Zstl, Xoi, Xoi, Xoi, Xoi, Xoi, Xoi
Xoi, Xoi, Xoi, Xoi, Xoi, Xoi, Xoi, Xoi, Xoi, Zstl, Zstl, Zstl, Zstl, Zstl, Xoi, Xoi, Xoi, Xoi, Zstl^Es, Zstl^Edb, Zstl, Xoi, Xoi, Xoi, Xoi, Qxua, Qxua, Zstl, Qxua, Zstl, Qxua, Qxua, Xoi, Xoi, Xoi, Xoi, Xoi
Xoi, Xoi, Xoi, Xoi, Xoi, Xoi, Xoi, Xoi, Xoi, Zstl, Xoi, Zstl, Xoi, Zstl, Xoi, Xoi, Xoi, Xoi, Xoi, Zstl, Xoi, Xoi, Xoi, Xoi, Qxua, Qxua, Qxua, Qxu^Bs|, Qxua, Qxu^Bs|, Qxua, Qxua, Qxua, Xoi, Xoi, Xoi, Xoi
Xoi, Xoi, Xoi, Xoi, Xoi, Xoi, Xoi, Xoi, Xoi, Xoi, Xoi, Xoi, Xoi, Xoi, Xoi, Xoi, Xoi, Xoi, Xoi, Xoi, Xoi, Xoi, Xoi, Xoi, Qxua, Qxua, Zstl, Zstl, Zstl, Zstl, Zstl, Qxua, Qxua, Xoi, Xoi, Xoi, Xoi
Xoi, Xoi, Xoi, Xoi, Xoi, Xoi, Xoi, Xoi, Xoi, Xoi, Xoi, Xoi, Xoi, Xoi, Xoi, Xoi, Xoi, Xoi, Xoi, Xoi, Xoi, Xoi, Xoi, Xoi, Xoi, Qxua, Zstl, Zstl, Zstl, Zstl, Zstl, Qxua, Xoi, Xoi, Xoi, Xoi, Xoi
Xoi, Xoi, Xoi, Xoi, Xoi, Xoi, Xoi, Xoi, Xoi, Xoi, Xoi, Xoi, Xoi, Xoi, Xoi, Xoi, Xoi, Xoi, Xoi, Xoi, Xoi, Xoi, Xoi, Xoi, Xoi, Xoi, Xoi, Zstl, Zstl, Zstl, Xoi, Xoi, Xoi, Xoi, Xoi, Xoi, Xoi
Xoi, Xoi, Xoi, Xoi, Xoi, Xoi, Xoi, Xoi, Xoi, Xoi, Xoi, Xoi, Xoi, Xoi, Xoi, Xoi, Xoi, Xoi, Xoi, Xoi, Xoi, Xoi, Xoi, Xoi, Xoi, Xoi, Xoi, Xoi, Xoi, Xoi, Xoi, Xoi, Xoi, Xoi, Xoi, Xoi, Xoi
Xoi, Xoi, Xoi, Xoi, Xoi, Xoi, Xoi, Xoi, Xoi, Xoi, Xoi, Xoi, Xoi, Xoi, Xoi, Xoi, Xoi, Xoi, Xoi, Xoi, Xoi, Xoi, Xoi, Xoi, Xoi, Xoi, Xoi, Xoi, Xoi, Xoi, Xoi, Xoi, Xoi, Xoi, Xoi, Xoi, Xoi
