Xu, Xu, Xu, Zxu, Zxu, Zxu, Zxu, Xu, Xu, Zxu, Zxu, Xu, Xu^Esd, Xu, Zxu, Zxu, Zxu, Zxu, Zxu, Zxu, Zxu, Xu, Zxu, Xu, Zxu, Zxu, Zxu, Zxu, Xu, Xu, Zxu, Xu, Zxu, Xu, Zxu, Zxu, Xu, Xu, Xu, Xu, Xu, Xu, Xu
Xu, Xu, Xu, Zxu^Esd, Zxt^Esd, Zxu, Zxt, Zxu, Zxu, Zxu, Zxu, Xu, Xu, Xu, Zxu^Esd, Zxu, Zxt, Zxt^Esd, Zxt^Esd, Zxu, Zxt, Zxu, Zxt, Zxu, Zxt^Esd, Zxt^Esd, Zxt, Zxu, Zxu, Zxu, Zxt^Esd, Zxu, Zxt^Esd, Zxu, Zxt, Zxu, Xu, Zxu, Zxu, Zxu^Esd, Zxu, Xu^Es, Xu
Xu, Zxu^Esd, Zxu, Zxu, Zxt, Zxt, Zxt, Zxu, Zxt, Zxt^Esd, Zxu, Xu, Zxu, Zxu, Zxt, Zxt^Esd, Zxt, Zxt, Zxt, Zxt, Zxu^Esd, Zxt, Zxt, Zxt, Zxt, Zxt, Zxt, Zxu, Zxt, Zxt, Hd, Zxt, Zxt, Zxt^Esd, Zxt, Zxu, Zxu, Xu, Zxu, Xu, Xu^Esd, Xu, Xu
Xu, Zxu, Zxt, Zxt, Ds^Usw, Hd, Hd, Zxt, Hd, Zxt, Zxu, Zxu, Zxt, Zxu, Zxt, Ds^Usw, Dd, Hd, Zxt, Zxu, Zxu, Zxu, Zxt, Hd, Hd, Hd, Re, Zxt, Re, Hd, Dd^Esd, Zxt, Hd, Hd, Zxt, Zxt^Esd, Zxt, Zxu, Zxu, Xu, Zxu, Xu, Xu
Zxu, Zxu, Zxt, Ds^Usw, Ds^Esd, 1 Ds^Esd, Ds^Esd, Ds^Usw, Re^Esd, Zxt, Zxt, Zxt, Re, Zxt, Re, Ds^Esd, Zxt, Hd, Dd, Zxt^Esd, Zxt, Zxt, Ds, Dd^Esd, Re, Zxt, Ds^Esd, Ds^Esd, Hd, Re, Ds^Es, Dd^Esd, Re, Re^Vhcr, Re, Hd, Hd, Zxt, Zxt^Esd, Zxu, Xu, Zxu, Xu
Zxu, Xu, Zxt, Ds^Usw, Ds, Ds^Esd, Re^Esd, Ds^Esd, Zxt, Re, Ds^Esd, Ds^Esd, Zxt^Es, Re^Esd, Ds^Usw, Zxt, Zxu, Zxt, Re, Zxt, Ds^Esd, Hd, Zxt, Re, Zxt^Es, Hd, Zxt^Esd, Zxt, Zxt^Esd, Hd, Hd, Ds^Esd, Ds^Esd, Re^Esd, Ds^Usw, Dd^Esd, Zxt, Zxt, Zxu, Zxu^Esd, Zxu, Zxu, Zxu
Xu, Zxu, Zxt, Zxt, Ds^Esd, 2 Ds^Usw, Re^Esd, Re, Ds^Esd, Zxt, Zxt, Zxt, Zxu, Zxt, Re, Zxt, Zxt, Zxt, Re, Re, Zxt, Ds^Esd, Ds^Es, Zxt, Hd, Zxt, Zxu, Zxu, Zxt^Es, Zxt, Hd, Dd, Re^Ldp/, Re^Ldp|, Ds^Usw, Cdr, Zxt^Es, Zxt, Zxu, Zxu, Zxu, Xu, Zxu
Xu, Zxu, Xu, Zxt^Esd, Zxt, Re, Zxt, Zxt, Zxt^Esd, Ds^Esd, Re, Zxt, Zxt, Zxt^Esd, Dd, Hd, Zxt, Ds^Esd, Zxt, Ds, Hd, Zxt, Hd, Ds^Esd, Dd^Esd, Zxt, Zxt, Zxu, Zxt, Hd^Vhcr, Re^Ldp/, Re^Ldp/, Zxt^Esd, Hd, Hd, Ds^Usw, Re^Esd, Zxt, Zxt, Zxt, Zxt, Zxu, Xu
Xu, Xu^Esd, Xu, Zxu, Zxt, Ds^Esd, Zxt, Zxu, Zxu, Zxt, Ds^Usw, Zxt, Zxt, Ds^Usw, Zxt, Hd, Ds^Esd, Ds^Esd, Zxt, Ds^Esd, Ds^Vhcr, Zxt, Zxt, Dd^Esd, Zxt, Hd, Hd, Zxt, Ds^Lrp|, Re^Esd, Re^Vhcr, Zxt, Zxu, Zxt^Es, Zxt, Dd, Ds^Usw, Hd, Hd^Es, Hd, Zxt, Zxu, Xu
Xu, Xu, Xu, Zxu, Zxt, Ds^Esd, Re, Zxt, Zxt, Zxt, Ds^Esd, Zxt, Re^Esd, Zxt, Ds^Usw, Zxt, Ds^Esd, Zxt, Hd, Ds^Esd, Ds^Ldp|, Re, Hd, Hd, Dd, Dd, Ds^Esd, Ds^Vhcr, Ds^Lrp/, Re^Lrp|, Ds^Esd, Zxt, Zxu, Xu, Zxt^Es, Ds^Usw, Re^Esd, Dd, Hd, Hd, Zxt, Zxu^Esd, Xu
Xu, Zxu, Zxu, Zxu, Zxu, Zxt, Zxt^Esd, Ds^Esd, Ds^Esd, Re^Esd, Zxt, Zxt, Hd, Zxt, Hd, Hd, Zxt, Ds^Esd, Zxt, Zxt, Re, Hd, Zxt^Es, Hd, Ds^Esd, Ds^Vhcr, Ds^Lrp/, Ds^Lrp/, Re^Esd, Re^Lrp|, Ds^Esd, Zxt, Zxt, Zxu, Zxt, Ds^Usw, Hd, Hd, Zxt^Esd, Hd, Zxt, Zxu, Xu
Xu, Zxu, Zxt, Zxt^Esd, Zxt, Zxu, Zxu, Zxt, Ds^Esd, Zxt, Hd, Zxt, Ds^Usw, Dd, Zxt, Zxt, Ds^Esd, Ds^Es, Zxt, Zxt, Re, Zxt, Zxt, Zxt, Re^Lrp\, Ds^Lrp/, Re^Esd, Re^Esd, Re, Re^Lrp/, Ds^Vhcr, Ds^Esd, Dd, Zxt, Hd, Hd, Dd^Es, Zxt, Zxu, Zxt, Zxu^Esd, Zxu, Xu
Xu, Zxu, Zxt, Zxu, Xu, Zxt, Zxt, Zxt, Re, Hd, Zxt, Dd, Zxt, Ds^Esd, Re, Re, Ds^Esd, Zxt, Zxt, Zxt, Ds^Usw, Ds^Usw, Ds^Usw, Zxt, Re^Esd, Re, Re, Re^Lrp/, Ds^Vhcr, Re^Ldp\, Re^Ldp\, Ds^Esd, Ds^Esd, Dd, Ds^Esd, Dd, Zxt^Esd, Zxt, Zxu, Zxu^Esd, Zxu, Xu, Xu
Zxu, Zxu, Zxt^Esd, Zxu, Zxu, Zxu, Zxt, Zxt, Ds^Esd, Zxt, Re, Ds^Esd, Hd, Zxt, Zxt, Re, Ds^Usw, Ds^Esd, Ds^Vhcr, Re^Lrp\, Re^Lrp\, Ds^Usw, Ds^Usw, Ds^Vhcr, Re^Esd, Ds^Vhcr, Ds^Usw, Re^Ldp\, Re^Ldp\, Ds^Esd, Ds^Vhcr, Re^Ldp\, Zxt, Ds^Esd, Dd^Esd, Dd^Esd, Zxt, Zxu, Zxu, Xu, Zxu, Xu, Xu
Zxu, Zxt, Zxu, Zxt, Zxt, Zxt, Re, Re^Esd, Zxt, Ds^Usw, Zxt, Re^Esd, Zxt, Zxt, Zxu, Zxt, Zxt^Esd, Ds^Usw, Ds^Lrp|, Re, Re^Esd, Re, Re, Re, Re^Lrp/, Re^Esd, Re^Ldp\, Ds^Usw, Ds^Usw, Re^Ldp\, Re^Ldp\, Ds^Esd, Cdr, Hd, Zxt, Hd, Hd, Zxt, Zxt, Zxu, Zxu, Xu, Xu
Zxu, Zxt, Zxt, Zxt, Hd, Hd, Re, Dd, Hd, Zxt, Hd, Ds^Esd, Hd, Zxt, Zxt, Zxu, Zxt, Ds^Usw, Ds^Lrp|, Re^Es, Re, Re^Es, Re^Es, Re^Lrp|, Ds^Esd, Ds^Vhcr, Zxt, Zxt, Ds^Usw, Zxt, Hd, Re^Ldp\, Re^Ldp\, Ds^Esd, Zxt, Zxt, Hd, Dd, Hd, Zxt, Zxt, Zxu^Esd, Xu
Xu, Zxu, Xu, Zxt, Hd, Dd, Re, Ds^Usw, Re^Esd, Hd, Ds^Esd, Ds^Usw, Ds^Esd, Zxt, Cdr, Zxt, Cdr, Ds^Vhcr, Ds^Lrp/, Re^Esd, Re, Re^Es, Re^Esd, Re^Lrp|, Ds^Vhcr, Ds^Esd, Ds^Usw, Zxt, Zxt, Ds^Usw, Zxt, Zxt, Zxt, Re^Ldp\, Re^Ldp\, Zxt, Ds^Usw, Re^Esd, Ds^Usw, Zxt, Zxt, Zxu, Xu
Xu, Zxu^Esd, Xu, Zxt, Hd, Dd, Re, Re, Ds, Ds^Esd, Re, Re, Re^Esd, Ds^Usw, Ds^Usw, Cdr, Ds^Esd, Ds^Lrp|, Re, Re^Es, Re^Es, Re^Esd, Re^Lrp/, Re^Esd, Re^Ldp\, Ds^Esd, Ds^Vhcr, Hd, Ds^Usw, Ds^Usw, Zxt, Zxu, Zxt, Hd, Dd, Re^Ldp|, Ds^Usw, Ds^Usw, Ds^Usw, Hd, Zxt^Esd, Zxu, Zxu
Zxu, Zxu, Zxt, Zxt, Dd, Ds^Esd, Hd, Ds^Esd, Re, Ds^Esd, Zsq, Zsq, Zxt, Zxt, Zxt, Re, Ds^Vhcr, Ds^Lrp|, Re^Esd, Ds^Vhcr, Re^Lrp/, Re^Lrp/, Ds, Ds^Vhcr, Ds, Re^Ldp\, Re^Ldp\, Ds^Usw, Zxt, Zxt, Zxu, Zxu, Zxt, Hd, Dd, Re^Ldp|, Ds^Usw, Ds^Usw, Zxt, Zxt, Zxt, Zxu, Xu
Zxu, Zxt, Hd, Hd, Zsq, Zxt, Re, Ds^Esd, Zxt, Zsq, Hd, Hd, Zxt, Re, Zxt^Es, Zxt, Hd, Ds^Lrp\, Ds^Lrp\, Re, Ds^Vhcr, Ds, Ds^Es, Zxt, Zxt^Esd, Ds, Ds^Vhcr, Re^Ldp|, Cdr, Zxt, Zxt, Zxt, Hd, Re^Esd, Ds^Usw, Re^Ldp|, Ds^Usw, Zxt, Hd, Hd, Zxt, Zxu, Xu
Zxu, Zxt, Hd, Dd, Zsq, Ds^Esd, Zxt, Zxt^Es, Zxu, Zxt, Zxt, Hd, Hd, Dd, Zxt, Zxt, Ds^Esd, Cdr, Ds, Re^Ldp|, Ds, Ds, Ds^Usw, Zxt, Zxu, Zxt, Ds^Lrp|, Re, Re, Hd^Es, Hd, Hd^Es, Ds^Usw, Ds^Usw, Ds^Usw, Re^Ldp|, Ds^Usw, Re^Esd, Zxt, Hd, Zxt, Zxu, Zxu
Zxu, Zxt, Zxt, Zsq, Re, Hd, Zxt, Zxu, Xu, Zxu, Zxt, Hd, Hd, Zxt, Ds^Esd, Zsq, Zxt, Ds^Esd, Ds^Vhcr, Re^Ldp|, Ds, Cdr, Ds^Usw, Zxt, Zxt, Zxt, Ds^Lrp|, Re, Ds^Vhcr, Re^Ldp\, Re^Ldp\, Ds^Usw, Ds^Usw, Ds^Usw, Ds^Usw, Re^Esd, Ds, Ds^Usw, Hd, Zxt, Zxu, Zxt, Zxt^Esd
Zxu, Zxu, Zxt, Re, Dd, Hd, Zxt, Zxu^Es, Zxu, Zxu, Zxt, Hd, Zsq, Zsq, Zxt, Zxt^Es, Zxu, Zxt, Re^Ldp/, Re^Ldp|, Zxt, Hd, Re, Ds^Usw, Ds^Lrp/, Ds^Lrp/, Re, Re^Esd, Hd, Ds, Ds^Usw, Ds^Usw, Ds^Usw, Cdr, Ds^Usw, Ds^Usw, Zxt, Re^Esd, Hd, Zxt, Zxu, Zxt^Esd, Zxu
Zxu, Zxt^Esd, Zxt, Zsq, Zsq, Hd, Zxt, Zxu, Zxt, Zxt, Hd, Cdr, Re, Zsq, Zxt, Zxu, Zxu, Zxt, Re^Ldp|, Hd, Hd, Zxt, Ds, Ds^Lrp/, Re^Esd, Re, Zxt^Es, Hd, Ds^Usw, Re, Zxt, Hd, Hd, Ds^Usw, Ds^Usw, Ds^Usw, Zxt, Zxt, Zxt, Zxt, Zxt, Zxt, Zxu
Zxu, Zxu, Zxt, Hd, Dd, Zsq, Re, Zxt, Zsq, Hd, Zsq, Zsq, Zsq, Zxt, Hd, Zxt, Zxt, Zxt, Dd, Re^Ldp\, Zsq, Dd, Dd, Zxt, Re, Zxt, Zxt, Zxt, Ds^Usw, Re, Ds^Usw, Zxt, Zxt, Ds^Usw, Re, Ds^Usw, Ds^Usw, Zxt, Re, Hd, Zxt^Esd, Zxu, Zxu
Xu, Zxt^Esd, Zxt^Esd, Hd, Hd, Zsq, Ds^Esd, Ds^Esd, Re, Zsq, Zsq, Zsq, Hd, Zxt, Dd, Re, Zxt, Zxt, Zsq, Re^Ldp|, Zsq, Zsq, Zsq, Hd, Ds^Usw, Ds^Usw, Ds, Hd, Re, Re, Zxt, Hd, Dd, Re^Esd, Ds^Usw, Ds^Usw, Ds^Usw, Ds^Usw, 3 Dd, Hd, Zxt, Zxt, Zxu
Xu, Zxu, Zxu, Zxt, Zxt, Zsq, Zsq, Zsq, Zxt, Zsq, Zsq, Re, Zxt, Zxt, Zsq, Zxt, Hd, Hd, Re^Ldp/, Re, Re, Zsq, Zsq, Cdr, Re, Re, Zxt, Ds^Usw, Ds^Usw, Ds, Zxt, Zxt, Zxt, Ds^Usw, Zxt, Hd, Zxt^Esd, Ds^Usw, Hd, Hd, Zxt, Zxt^Esd, Zxu
Xu, Xu, Zxu, Zxt, Hd, Dd, Hd, Zxt^Esd, Zxt^Esd, Hd, Hd, Zsq, Re, Zxt, Zsq, Zsq, Re^Lrp/, Ds, Zsq, Ds, Hd, Re, Cdr, Zsq, Zxt, Hd, Zxt, Zxt, Ds^Usw, Re^Esd, Zxt, Zxu, Zxt, Hd, Zxt^Esd, Zxt, Zxu, Zxt, Zxt, Hd, Zxt^Esd, Zxu, Xu
Zxu, Zxu, Zxt^Esd, Zxt, Zxt, Dd, Zxt, Zxt, Zxu, Zxt, Zxt, Dd, Hd, Zsq, Hd, Zsq, Zsq, Zsq, Zsq, Zxt^Es, Zxt, Hd, Zsq, Dd, Zxt, Zxt^Esd, Zxt, Ds^Usw, Ds^Usw, Ds^Usw, Re, Zxt, Ds^Usw, Dd, Re, Zxt, Zxu, Zxu, Zxu, Zxt^Esd, Zxu^Esd, Zxu, Xu
Zxu, Zxt, Zxu, Zxu, Zxt, Zsq, Zxt, Zxu, Xu, Zxu, Zxt, Zxt, Zxt^Esd, Hd, Zxt, Zxt, Zxt^Esd, Zsq, Re, Hd, Dd, Dd, Dd, Hd, Zxt, Zxu, Zxu, Zxt, Hd, Hd, Hd, Ds^Usw, Dd, 4 Re^Vhcr, Hd, Zxt, Zxt, Zxu, Xu^Esd, Zxu, Xu, Xu^Esd, Xu
Zxu, Zxt, Zxt^Esd, Zxt, Ds, Ds, Zxt, Zxu, Xu, Zxu, Zxt, Zxu, Zxu, Zxt, Zxu, Zxu, Zxu, Zxt^Esd, Zxt^Esd, Zsq, Zxt, Zsq, Hd, Zxt, Zxt^Esd, Zxu, Zxt, Zxt^Esd, Zxt, Xu, Zxt, Zxt^Esd, Zxt^Esd, Hd, Zxt^Esd, Hd, Zxt, Zxu, Zxu, Xu, Xu, Xu^Esd, Xu
Xu, Zxu, Zxu, Zxt, Zxt, Zxt, Zxu, Xu, Xu, Zxu, Zxu, Zxt, Zxu, Zxu, Xu, Xu, Xu, Zxu, Zxu, Zxt, Xu, Zxt, Zxt, Zxt, Zxu, Zxt, Zxu, Zxu, Zxt^Esd, Xu, Zxu, Zxu, Zxu, Zxt, Zxu, Zxt, Xu, Zxt, Zxu, Zxt, Xu, Xu, Xu
Xu, Xu, Xu, Xu, Zxu, Zxu, Zxu, Xu, Xu, Zxu, Xu, Xu, Xu, Xu, Xu, Xu, Xu, Xu, Xu, Xu, Xu, Xu, Xu, Xu, Xu, Xu, Xu, Xu, Xu, Xu, Xu, Xu, Xu, Xu, Xu, Xu, Xu, Xu, Xu, Xu, Xu, Xu, Xu
